BEWES	BENES
LUC1F	LUCIE
EYHF	EMMA
EL1I5E	ELISE
H0NNFLT	HONNERT
PAVLJNE	PAULINE
R0MA1W	ROMAIN
CYPRPIEL6E	CYRIELLE
LIL0U	LILOU
N1TH1EUX	MITHIEUX
TH0MAC	THOMAS
HHAL1S	ANAIS
JAFFEUX	JAFFEUX
PYREV0ST	PREVOST
RMANE	ROMANE
BRUFERIE	BRUGERIE
110RKNTIN	LORENTIN
ELISA	ELISA
MAUPAS	MAUPAS
MEYS0SA	MEISSA
41IQLJVW	REBACH
EFKLLII	ERWAN
AM3RLNLSE	AMBROISE
ELMKKALI	ELBAKKALI
SEKZ1WF	BENZINA
IAQWRRIERE	LAQUERRIERE
YQEL	YAEL
VITREL	VITRE
GUFLLJG0GUH	GUILLOT GOGUET
XA7HES	MATHEO
HAL	SHA I
VJSTJRJH	VICTORIA
MPRBIER	BARBIER
DUPRAJ	DUPRAT
LEBAQH	LABARH
REMI	REMI
ARGLTXU	ARGITXU
HCLKL1LWVEY	RODRIGUES
H1JMINE	AUBANE
EPLYISA	ELISA
YAM0VR1I	ACHOURI
ANF0YNC	ANTOINE
JULIE	JULIE
YW	BGUGEAU
TR0UVAY	TROUVAT
CCRALLLE	CORALIE
JVANDENABEELF1	VANDENABEELE
ASHLEY	ASHLEY
AHBRC3	AMBROSS
GAH0T	GAROT
HILIANI1THIM	MILIANI-THIBA
THPFEY0	THEO
V1INCEKT	VINCENT
L0VIS	LOVIS
VPERSTQHTE	VERSTRAETE
LV6Y	LUC
CUILL0	GUILLO
C0LLIW	COLLIN
FER0N	FERON
MUYESHIL	DAUMESNIL
B0UTET	BOUTET
BEKNARD	BERNARD
MNLAHW	BENLAHSEN
CCSSA	COSSA
BEL0E1LL	BELOEIL
MARTFNJI	MARTINS
WC0NHIER	BRACONNIER
GAPTFSTE	BAPTISTE
5ATDANI	SATDANI
VJNI0TTE	VINCOTTE
BEH5AISMEM	BENSAIS RUEDA
LULI	LUC
GARCJA	GARCIA
ALEXAWDRE	ALEXANDRE
MALTET	MALTET
PYFREZ	PEREZ
ANME	ANDRE
GU5T	GUST
LI1JJZ	LIUUT
CLAWL	CADWAL
WATTTEZ	WATTIEZ
C0FN0N	CORDON
RAYYYHYH	RAYAN
CUCHERIL	CUCHERIL
F0NTAIWE	FONTAINE
SIKM	SIMEON
GAREIA	GARCIA
LEGR1VD	LEGRAND
C0PRYEWIW	CORENTIN
LH1TH	ENATH
EMHA	EMMA
Z0LUYS	MOLDE
TKHSTAW	TRISTAN
R0DRZG0EZ	RODRIGUEZ
PHAW	HAJJI
CR0ENNE	CROENNE
L1TL0U	LILOU
Y0C0UBI	YOCOUBI
TUUKY	ROUES
IYFZY1LYGF	MAXIME
YWMA	GIBAJA
R0HRT	ROBERT
JEL01ALSLHW	ELOISE
AHAL	AMAL
NYLAW	DYLAN
VIE0	UGO
FLCRA	FLORA
EL0ANI	ELOAN
HDV8HULT	DUAULT
BMSSAW	BROSSARD
GWEH0LN	GWENOLA
TAH5V1V	TANGUY
LLA2ULFNIE	CAROLANE
EDUAL	EDGAR
7UH0UX	DUHOUX
CLEMENT1GHLTYER	CLEMENT-GAUTIER
THMAJ	THOMAS
CSLAR	OSCAR
SARAH	SARAH
CAUTHILER	GAUTHIER
GV1LHEH	GUILHEM
Y0H9H	YOHAN
KLXRA	KLARA
BENWERDUF	BENKHEROUF
PERRINE	PERAINE
REDA	REDA
C0Z1H	COLIN
HENEVVRIER	HENEUVRIER
HELLEH	HELENE
CHHRL0TTE	CHARLOTTE
QUEHERE	QUEHERE
GAJ00	GANOO
LUUI5	LOUIS
BERGEAULT	BERGEAULT
GUILLEMETTE	GUILLEMETTE
HUG0	HUGO
6AVETT11	GAVETTI
RAWRL1HII	RAMERINI
HAUD	MAUD
GCN1X	GORIN
TYHIKL0Y	THIRION
C0UH5	COULIS
HRHWV	ARADJ
FLDRA	FLORA
AYYCRICH	AYMERICH
N0E2	NOEL
EIYSYA	ELISIA
SASHA	SASHA
B0NWYE	BONNIE
PINEAV	PINEAU
PLJCHDA	PLICHON
WHAHEDNNLT	NOHANED-ALI
T0NY	TONY
ZH0H1IMHW	ZOHRA
GUILLET	GUILLET
APLUY	ALIX
FLAVLIE	FLAVIE
6R0LLEHU	GROLLEAU
HUGVE	NUGUE
B0HHEF0UX	BONNEFOUX
ALWHAYJ	ANAIS
M	TUIGI
S0LEWC	SOLENE
1HARTRFN	CHARTRIN
SIM0W	SIMON
PAUL	PAUL
JLHELL	SCHELL
APAQEN	ADRIEW
P0LLET	POLLET
UQBL1K	ALBIN
MLHALI	MIHAI
LILIGW	LILIAN
MHFT1W	MARTIN
T4CN	THCO
LECAVNE	LECAUDE
LE0	LEO
JYATHFEU	MATHIEU
MV0U1DELDRNE	MVOU DELORME
CEHHE0LAVAHT	CONDE-LAVALETTE
ALY55A	ALYSSA
AFULLINE	APOLLINE
ADRFEN	ADRIEN
PERRKIR	PERRIER
HEWAGFR	MENAGER
CLARA	CLARA
UWPY0	MUGO
LPUL1E	LUCIE
BRUEER0LLE	BRUGEROLLE
PIGUET	PIGUET
JAVBERT	JAUBERT
9HEMTQN	QUEMTIN
AXELLE	AXELLE
TPYG5T0UAH	TITOUAN
LUC1LE	LUCILE
HFNLHAHD	HARCHAND
BPYIG2YNW	BRITNEY
H0HEVLFE	HOLLEVILLE
CLARA	CLARA
HHH	FEMIET
ANATS	ANAIS
WPPHZLLE	CAMILLE
KHFLUKWT	KHELOUFI
WWE	CHLOE
BA5TFW	BASTIEN
W0EHK	NOEMIE
BLCWMHU	BLONDEAU
LYND5HY	LINDSAY
URET	DERET
KHUET	BEHUET
SY	SY
BKI6IAXN	BREGEARD
KELLLAH	KELLIAN
DEBMLLEUL	DEBAILLEUL
4AFYTAN	TRISTAN
L0UJJAL0UP	LOUIS-LOUP
AVRELTEN	AURELIEN
KYL1HH	KYLIAN
VALENT1N	VALENTIN
GAVT1IEK	GAUTIER
YAPWYDN	MANON
DE6EN0UILLAC	DE GENOUILLAC
HEWRL	HENRI
V0LPF	VOLPI
WGUER	NGUER
HA0UACHE	MAOUACHE
YHADY	MARDY
DURAHDI	DURAND
CLENENCE	CLEMENCE
AW0W	ANTHONY
CLEMENT	CLEMENT
L0UCFH	LOUCIB
BE5UE	BEGUE
S0LRL	SOLAL
HH	DEBBLASI
MRIE	MARIE
CHEIERE4U	CHEVEREAU
CHR0HU2ETWIVIEN	CROUZET-VIVIEN
L0U1S	LOUIS
NL0FEL	NAOFEL
CARE04J0BERT	CAREO-JOBERT
LDULF	LOUIS
BRI1UN	BRION
BACHELARD	BACHELARD
AVGUHZN	AUGUSTIN
B0USFITE	BOUSTIE
LYDTH	LYDIA
F1ISCHM	FISCHER
CHAMAH0W	CHAMBRON
YA5JIH	YASSIN
REMY	REMY
ALEXLS	ALEXIS
LYLERQUIH	CLERQUIN
BEHA2IE2	BEENAZIEZ
JYEU	JEU
K0CH	KOCH
RAHSEYER	RAMSEYER
FYERRDS	PERROS
LYLANPI04	CHAMPION
HUW	HUGO
1JERVE	SERVE
LULA5	LUCAS
DR0IHEAU	DROINEAU
R0Y	ROY
BM0R1CS	BORIES
IM1R0YUYMEYNPGY0PUYY	ROUMENGOU
LY1ZL11E1LE1NJSKF	ZIELENSKI
MLRUE	DELRUE
Y1A1SNN1NNEAANHNTHNM1IW	SINEAD
CMR0TLAT	CROIZAT
W1YUYYEYYLWDSTKVVX4	ZIELENSKY
LF1ASAL1TGIEY	ASAITIE
PH1LSLI1ILE	PAULINE
CUUUAKU	GOUDARD
TM0UHSSEYPIVYLP	TOURESSE
ERP1YKA	ERIKA
HJQ	ELSA
K0URY5HA	KOURISNA
L3SE	LISE
AMF1YDYY1FYYALYUN6RHYAY	DIALUNGANA
C0MBZ	COMBE
K1E6LER	LIEGLER
NDURDHN	NOURDIN
LMWL1YWMA1AUTL1ILL0VI	MAATI
MY1MTULY7VYHCIYLJJ	JOSSE
MEUNTER	MEUNIER
PLBEHJHNLH	BENJAMIN
LELYAIHE	DELMAIRE
HM1GWEGPUENYYI	GWEGUEN
M1SARAH	SARAH
IRHNI1LE0NARD	FRANZ-LEONARD
TMIRH	TEIXEIRA
MLLS1HAC1HNAHHLHMIK	SACHA
DALLI	DALLI
MP1YHYY0WWVKVWUL	GEORGES
FL0AA	FLORA
BHNL1TI1	BRIOT
IW6PPL0LYYL0PPWPYYY	PILLON
LG1YM0RYAYRYDYYPYY	MORARD
AMWMNHWVRHW	ARHUR
THIBAULT	THIBAULT
KUGUE	FAUGUE
MLRAFAFH	RAFAEL
LEPAGE	LE PAGE
WLE0Q0ANVNEWLVVYFUN	LEOGLONNEC
LLF14FVIFGDIGYHU	MFUIDIMAU
BAR0UKH	BAROUKH
CWLENENCE	CLEMENCE
5HAR0N	SHARON
LULERE	LECLERE
DUIUY	DUFEY
M1TWHW	EVAN
WLHUG0F	HUGO
WIC06E9	NICOLEY
MW1YFMELVRCJJH7ECTWNTN	FERCHECHE
LMY1YWRWLVYEYHVVUD	ROOSE
B0RJ0N	BORSON
M1A4H8RYC	AZHERIC
M1FELIX	FELIX
M1JHYYUEYTVVALVVYL	HUET
M1NAXIME	MAXIME
MYJPW0I4YLDVJEITYYYJ	POILVET
MYL1NE	MAYLINE
MY1YYKHYVEVFIFW0JLPG1VLKLULLI	KHETTOUP KACI
1MLCHHV0TL	CHAVOT
HBEHHM1IN0	BENJAMIN
MLHELIA	CELIA
LWAT0	LODATO
YLYAXJTE	MAXIME
MY1YPM01RYIELFLJPV	MOREL
EVCWH5	EVENAS
MMKMMAWNENW	ROMANE
Y1LEA	LEA
HAHFM	MARTIN
IM1WYAXXYXXHAIJI1LA	ILLIAMHAJIUA
H0VA1LLES	NOVAILLES
MIARLGAVXHLJ	MARGAUX
MP1YHYYUYP51YAY2YIIL	MUSIAL
Y1CHARLE5	CHARLES
BAHIEN	BASTIEN
MLR0MA1W	ROMAIN
YISAHALLH	SANA
DWEJFSU5TEIKFJRA	DEJESUSTEIXEIRA
JW1PMAVY0GUYWIVAYQAKY0UUA	HAVOUNIA-KOUKA
M1FHLLH	FATIH
T9TL1AHH	TATIANA
WMILL0NHET	GUILLONNET
WLDQII1	VATEL
C0RZXT1N	CORENTIN
LP1EL0LSE	ELOISE
HELAL	HELAL
Y1BEPNNGERE	BERANGERE
BVENM0ULBIED	BEMOULBLED
LI	LI
LMMYYYYNN	LONG
MLPIERRE	PIERRE
MWZUCHXWJINM	LUCAS
LARR1CU	LARRIEU
HYDYE	JADE
PLN0RIYE	NORINE
M1GREG0IRE	GREGOIRE
AWTWINF	ANTOINE
1SCIJLHW1	SOPIANE
MLHIRERDCT	GIRARDET
YAYLENTLN	VALENTIN
YLWJJXJEJNLEHIH	MAXENCE
ML5ULTAWI	SULTANI
AM1PPEYGHIRDLYIL	POEGARD
YLMAW0NL	MANON
P1IMENE	IMENE
YLLVLEYRLYEVYYICPMVWM	VERLEYCN
MLP1IZEHKEL	PIERRE
DLLIILTY	DUCULTY
P1MIAANA	MIRANA
EHHA	EMMA
HLFYAUDRG	ALEXANDRE
LMM1B0HLL0NY	BOUILLON
JLMHUUJEHHL	JULIE
XLBAN	ALBAN
R0MA1N	ROMAIN
ARTUK	ARTUR
Y1GREBWN	BREGEO
MYLYPYVYVEIYLVVJJLI	PUES
MYPYLYDYESYSYEYYVREY	DESSEVRE
MLTAWE	JANE
P1C0RALTC	CORALIE
TAIHLEFEK	TAILLEFER
FLKYDHJR2J	ALEXANDRE
QMJEVXM11LY	EVEDJI
WLUCILLE	LUCILLE
JEPAEIHY	SEREMY
Y1ESTEBAN	ESTEBAN
HEHD7	MEHDI
2APHAEL	RAPHAEL
Y1ANANDFNE	ANANDINE
CHL0E	CHLOE
5MJMGYYYYYP	SIAD
Z111ALIIAIAHNNLNM1IW	LEA
Y1VAYLYEM1LW	VALENTIN
TU1L	TOUIL
MWYPYYY5SYYIVVVWJJLI	VERISSI
HFRBRETEAU	HERBRETEAU
LMECLERCQP	LECLERCA
MWLECK11WLEW	CECILE
FMEETERMFHIYSYVB7YP	PEETERMANS
PAP0T	PAPOT
M1ADELYS	ADELYS
BRMH	BRIAN
FICZEL	FIGIEL
WEN36UZLYYLY	HAZGUI
MLEC0UPILY	LEGOUPIL
C0RBELL1NJ	CORBELLINI
HLHHIBINAHI	ALANI BINANI
PE5CE	PESCE
YFMN	YANN
M1L0U	LOU
APKR	APER
5WEMARYYLY	SEMAR
VLCT0R	VICTOR
YYYGLPM0YRYBUFGPIYY	MORBU
WLW	LOU
AV6USTE	AUGUSTE
MH1V0EEL	TAVOREL
CHAPE6VLER	CHAPELLIER
MLNATHAN	NATHAN
WERA11SCHE	GUERAISCHE
LELUHFF	LECONFF
HY1YYREPYV2PLLIYY	REY
M1MATTHLLEU	MATTHIEO
CAM0WHMHWIHHH	CORENTIN
GLIIK1LTLI	SARAGOSLI
HEIET	NESET
0MLBELYBYALLYAHI4QPV	BELBACHIR
WWWITNAMY	WITTMANN
MLELW1ARD	ELOUARD
Y1FAUL1WE	PAULINE
LM1LGYYUJYIPEIRYTFYVU	GUIBERT
H0VL	HOUL
LWKHYLHFJAXHHLJ	KYLIAN
ETIEVE	ETIEVE
NRTHAX	NATHAN
VASSAL	VASSAL
KLYLIAN	KYLIAN
HUG0	HUGO
Y1LALLY0JPWYGPY	ALLOING
BRCCH1ER	BROCNIER
MY1HWA0VCYXYHU0H4YD	BACHELOT
EWIDEM0WNLLLET	DE MONTILLET
GUFLLAUME	GUILLAUME
HALAVRY	MALAURY
YLRAFIILNLLPGAUBEKT	RAFINI-GAUBERT
YLCW5TANT	CONSTANT
VISJED0	VISIEDO
MZLZSSA	MELISSA
NM6PSEGULIIYNEPAVYUV	SEGUINEAU
H0RTJSEAU	MORISSEAU
DLARRA	DIARRA
Y1C0N5TANT	CONSTANT
LWAMPE	LAMPE
MM6YBWRFUVYYCIR1EI70U	BRUYERE
MARHAHI	MARIANI
GUIMLER	GUIMIER
W1BAYLEYY	BAYLE
JCHWAHLZKR	SCHWARCZER
W1UITTNNF	VICIAR
BQYRRM0CV1	UNREADABLE
LY16ULLLE1RH1W	GUILLERHIN
ARNAU0	ARNAVO
MFYLPYEYUYRTYYWIVWY	FLEURY
M1LAYAWE	LAYANE
WYBELYVLEPYUUQIVPJZU	BELVEZE
EVA	EVA
NAK1L1E	MARILIE
MW1MLWIIDVAYWYIT0BGT	LADAWA
MM1MHWUTSW10TYEUTL7L01V	MUSITELLI
SWHADLL	SAADI
DMWTVWBIIHN010L0BMYBLAYIL4IIV	DI - BIN - LOMBARDI
1JFSDEL0UP	VISDELOUP
LY1P5AYULIJIPENRJGYP	GAUTIER
K0URUAD	KOURRAD
YEPHE	ELIO
LY1SEH	LISEA
CHARL0TTF	CHARLOTTE
LNWJEHJMHG1HH	MEHDI
M1TL0KSLU	FLORESCU
FFLMWLYCMHIUEQTYALUUV1M	CHENAL
MPPYTISTE	BAPTISTE
P1PAULINE	PAULINE
HAYATE	MAYATE
5CHW0CRER	SCHOWOERER
LYAVALMMH	LAVAL ROMAN
MW1YMMLCVJCGHY10JJVHL	BECCHIO
PMPDUYGYE0YYLLYEJIVJVP4	POUGEOLLE
WMFRACAYPYYIFVY	DAGRACA
WMLMWER	HOLLANDER
MLEL10TT	ELIOTT
MW1YAWLLLVAUR0DVVVLC	ALLARD
CLENEWTIWE	CLEMENTINE
LLZEA	LIZEA
30URQEAY	BOURGEAY
FL1XAR0CF	MAROC
Y1L0U2IER	LOUZIER
HADJF0THMANE	HADJ-OTHMANE
JML6ERVAYYY5Y	GERVAIS
E1VAN	EVAN
RWENHR7	RENARD
MWAVGNUWSTINHW	AUGUSTIN
YMCL	MANEL
LNM1LPECVQIUYEYRYYYLV	PECQUERY
M1RLVAHS	RIVAS
BM0RL5	BORIS
P1FABJ0IIHLH	FABIO
DES6LDUS	DESCLOUS
Y1THG1LYIAFIC0	TAGLIAFICO
CQL0M3EL	COLOMBEL
NWWERWYYW	MEYER
Y1MATLHLILLDE	MATHILDE
LAUUEW2N	LAURENZA
M11LIJJIF	GIANNI
50FIANE	SOFIANE
CYR05	CROS
MEM	PENELOPE
WLLH	NOLAN
PWYRIAH	MYRIAM
0EFEVER	DEFEVER
NEL1KE	MELIKE
MVJEHNQYJAPVJW	VIENNOT
LHL11SSQLFK	LAUISSIER
0UB0IS	DU BOIS
AANTHEA1	ANTHEA
IFLFHHELRNIAJNDE5	FERNANDES
WEWHKNQLWEHA	EMMELINE
P1LUI1SL1I5MGEL	LUIS-ISMAEL
IL1NA	ELINA
DACWSTA	DA COSTA
MP1YFYPYVSJCHIJERI4JY	FISCHER
MIIEU	MATTHIEU
IDMJMRDUNY	MARDUN
LRS5AGNE	LASSAGNE
LMWUCMLWCNMI	LUCIE
LML1L1YACA1YI1	LUCAS
GALJRTRE	GALVAIRE
ANDKTCUY	ANDRIEUX
M1HAYZYS	MAILYS
MW1YMWDLYAGYV1JJY	NOA
CKE3HRDL	CABROL
5PIBW0RL	SIGNORI
APPASSAHY	APPASSAMY
WYUJAHID	MOUJAHID
BMRAWD1IHY	BRANDILY
TRLSTRW	TRISTAN
WMHU	BOCHU
CHAFT0N	CHARTON
GASSAYK	GASSAYE
Y1ZURABIANLI	ZURABIANI
HSWINJ0QNHW	SIMON
RQW5E	ROUSSE
P1T1YUM5	THOMAS
M1GLALFLREA	GALFRE
WJCANELLEF	CANELLE
WMFIUEYVPYAVYV	LAFITTE
CRMLLE	CAMILLE
MTHAW0U	MANON
LMW1YSWIIXVYVYILUYN	SIX
NMLLALYVESYYIYY	ALVES
GAWIER	GAUTIER
LUUFIL	LOVAIL
HELAC0UR	DELACOUR
M5ANAE	ANAE
BM0UR6E0I4Y	BOURGEOIS
F0R7RIE	FORTRIE
FWYIYYFA1TVHVHJYWEVPVN	FATHANE
ADR1EN	ADRIEN
W1CIHA1P1EALFLC	CHAPELLE
LHELAMAT	CHELAMAT
FL1HBE1NHJAAAMH1INLIHLL	BENJAMIN
UYLLLE	CAILLE
YTZPHAH	STEPHAN
8LEX1I5	ALEXIS
ELI2	ELIQ
MLANT0INK	ANTOINE
WATHAN	NATHAN
MLAHDUVE	LAHOUVE
DHIXHIN	DHINNIN
VI6NNUD	VIGNAUD
JMWULKLWETTEW	JULIETTE
LEC0UCHH	LECOULAN
MM1MWWAJVVYETY1SJJN	NAVET
F0HR	FORSTER
MSWEHNWWNM	SELEN
WLLL1AH	WILLIAM
P1JVLFS	JULES
MW1MWCH6EU2LXY0DTJQUYL	CHERNOV
JCNHTHHW	JONATHAN
1M1FL0RLSL	FLORIS
NARIELLA	MARIELLA
HBDERHAHMYWE	ABDERRAHMANE
Y1NEHELMYIE	NOHEMIE
RU5FMAHW1	RUSSMANN
YMAF1E	BRICE
MI1HIAF11AJA	HARAJ
S0LAZ	SOLAL
CHN	CAEN
M3AI	RABAI
JMGRATI1NAPPLPP	AGRATINA
0H04E55IDW	OHANESSIAN
HYTDUAH	TITOUAN
L1EA	LEA
NATHILDE	MATHILDE
LHWJPBEAYUYYWYUIVFNYY	BEAUDOVIN
KERYAN	KERYAN
HMYPRYDY1HYYWUYYY	SARDIN
BLZHEVA	BIZHEVA
FMM1MHWLPDAYLA7IDF2S6W	VLALADE
6UERRLER	GUERRIER
THEK0H	THERON
P1XUG4	HUGU
FMUQILLHUMEYY	GUILLAUME
MLLFGMAW	LOOMAN
MARJ0AIE	MARJOAIE
IW1CAVALILR	CAVALIER
M0KHTAAI	MOKKTARI
HWHRG0T	MARGOT
QWJSY	RISS
MLMHJHQ	MISHA
MLR0XAHHE	ROXANNE
CLHHWE	CHLOE
BMELLE5YPYYYYYY	BELLES
PLL0U1ANM	LOU-ANNE
UATAIN	CHATAIN
MP1YWYYRVVWJVPWC	GUAY
HWNQUELAYYYL	ROCQUELAY
LECLNREC	LECLOIREL
F1R0NEIYLL1H	ROMET
DEBCYSSE	DE BOISSE
JUHMFY	JOANNY
HT1N1IFHW	TING
NATHAH	NATHAN
THIPALUD	THIBAUD
TMASYVYYYYY	TAS
Y1LEAGUHGNIYEYR	LESAULNIER
DUT0ULYN	DUMOULIN
HRNEL	ARMEL
GMWAUMTWHLERNM	GAUTHIER
LL3LLISALLAHH	LISA
YERL1CHR1ZELDA	YERI-CHRIZELDA
HWV0IH	MARVIN
MM1YKAYLIY4SVLVVLL	KALIS
WYSHA	SASHA
NAUD	MAUD
M1ILLAN	ELLAN
M1ZDE	ZOE
CYANEEL	CYANEE
EHJRRIN	CHARRIN
VELH5C0	VELASCO
I1G1W1WI	NADIR
HATHFEU	MATHIEU
SWMAHMCWCLAA	SAMUEL
MDEY1SMWVY7IPIIY	DE VISMES
YLLHUMEYR	LHOMEER
CAPHYLLE	CAMILLE
AILEX	ALEX
FWRES5EG	FRESSE
PHMAUJLHHHLJ	PAUL
JQNN	JOAN
MMCH	BACHS
MW1YMYAYILHTJJLLCI	ROT
WLJSRLINE	ISALINE
5EPMYEN	SELMEN
WBLIVET	BLIVET
CM1BERHAB	BERHAB
M1ELDUEH	ELOVEN
KM5TF6	ASTIC
P6LUKAS	LUKAS
P1CHARLES	CHARLES
NLICE	ALICE
MWD0MMIWT1ILLENM	DOMITILLE
PLYCKENFEYYYV	CHENE
IM1LFYBGYHGAIHYY	LE BIHAN
KM1XFBYGERGAVYP	RIBERA
E0UNTHJV0H6	SOUNTHAUONG
LHWHAAHJWHHA	CHAIMA
HATHIL0C	MATHILDE
CWWHANRWL0TYENW	CHARLOTTE
LLFL1LLI0UHIA3HLHHIHHLH	LOUISA
F1L1MA1RLIHENLLINMIW	MARIE
MM1MWSUIVIHVVFNYJLF	SUCH
GALLA1I	GALLAI
W0RKY5SE	BREYSSE
DCWDT	DINDTL
JUSTJNE	JUSTINE
PAUL	PAUL
MMHE0	MATHEO
LY1FLJI5HH1	ELISA
PLMUL	PAUL
EMCLE	EMILE
MDURUPTVIVYYY4	DURUPT
LMLFERYRL	FERYAL
VW1MLY4YY	VILLETTE
SCARPARI	SCARPARI
WPEHK	VICENTE
MCWEDMRW1CAM	CEDRIC
FHT2LET	BAILLET
M1AHRYLKN	ADRIEN
NM1CNCVYETY	CHOUYET
ETHAN	ETHAN
NYCHEL	NICHEL
MY1YHPULZTJAJHZJ7T	HUET
WLWYLUHYRTL	HUBERT
MW1MNMZIPVNWLJINDJKI	DINOU
YNWMMMIWGHHEAW	MARIANNE
HEL0RA	HELORA
NAMYN	MARTIN
TNLAJHNC	TRADO
KAKL	KARL
PGRFHT	PARENT
FLMLIDU1ML0N1CEAU	DUMONCEAU
WWW1GLWLUETTME	GUILLEMETTE
JK0D0N	JEUDON
HYATYHILDE	MATHILDE
WPIGWTPYYY	PIGUET
AHNHLKI1H	ANAIS
ALHTWC	ALHINO
NM0CGUPRTYYYPY	MOCQURRT
THINAUT	THIBAUT
UMMWE	VALETTE
PYW2THEW	MATHEW
EYYLISI	ELISE
MPWIEMRWRENM	PIERRE
WMM5VIPYNYUN	SIABAS
LLEMEYT	CLEMENT
LAW1BESYTYAY0UYI	BESTAOUI
MMWWW	MARCOS DE LIMA
LLWHELJ1HAHHHJ	CELIA
HUMBERT	HUMBERT
AKBABA	AKBABA
LM17AYNA	RAYNA
IM1PDEGVYUVFNVIE5VIY	DEGUINES
JAEH	JAEN
DELETRE	DELETRE
MHMEHJDJYIH	MEHDI
M1YALENTIN	VALENTIN
SYAL0NE	SALOME
MRYMARC2YYXIYYIYYV	RYMANCZYK
MATEN	MATEO
MMW0R6HNNM	MORGAN
M1LILIAN	LILIAN
DEHAP0RTALLZRE	DE LAPORTALIERE
HEGALLIC	LEGALLIC
DUR0UXAIRATIGNER	DUROUX--RATIGNER
IMLDENAYVDYGY	DENAND
HANHAH	HANNNAH
HEUUM	MEZOUAD
YANHZSII	YANNIS
HFL0IFREHTNM	FLORENT
SEIFNEUE	SEIGNEUR
GMWHYYYYYVI	GUYOT
NHELLE	MAELLE
M1ALLCIA	ALICIA
MJHANUN	MANON
P1HELME	MELODIE
YLEGELE	EGELE
LMP1YMYAIRHY4NNVVNUU	MARY
FYM1MWTJCVHTEY71T4NJ7Y	MICHEL
Y1EVAYN	EVANN
HMWNME	HONNORE
M1YWYYTYTPEYYLPLEGIJ	WATTELLE
YAHJY	YANIS
Z1I1J0NADHEANHA0NM1IW	JADE
GLMAIWEHH	MAIWENN
JYWHE	ISAURE
JVDNTNN	JOANINA
S0UL1IW6EAS	SOLINGEAS
ALEXANDKE	ALEXANDRE
KENT1N	KENTIN
WANE	WANG
AMTIWZAPV4PY	ATIENZA
M1LWICLLHYY	NOLLET
YZTITJENN	PETITJEAN
MARCCAL	MARCEAU
VI0LETTE	VIOLETTE
IW1LLRYUYYEPL1LZILIIERI	CRUVEILLER
LPL6C1AIMLIHLHLIEIINM1NW	CAMILLE
JMLRUSGJHYEYLLL1Y	BUSINELLI
MBIN	ROBIN
H0HH	NOAH
M9FHK	MAGNE
CHUHIER	SAUNIER
KMHA2L0UWYFVYPY	KHALDOUN
HLWHARJTJEHLH	MARIE
M1HFIHA	MAINA
MAHAVT	MAHAUT
Y1ETTHDILLI	ETTADILI
HWHHE3H	BENCHEIKH
JEMUEY	JEANNEY
WWNNP	SUMTITH
KEYL5ER	KEYSER
SCANDER	SCANDER
L0ZES	LOZES
CLARA	CLARA
QUEHNEHEH	QUENNEHEN
MLLMLLAXALHMILIHHMLW	MAXIM
UM1BQUYQYIUEGTP	BOUQUET
AM1L0STVEVYRPVVIY	OSTER
HMUW1	HUGO
M1ANELH	AMELIE
HMHAATAWHWHH	MATEO
NDREHVIILLE	MORENVILLE
QMLGJBLALDJP	GIRAPDI
HHRWAN	MARWAN
NMTLDBYAGRYTYHYFYV4	LABARTHE
JM15EIYSQ	SEYS
WMAWANYWSNM	ANAIS
P0NS	PONS
RMYVLEREYFPFYY	RIVIERE
JULIAHHE	JULIANNE
CLWD4	CINDY
W0E	NOE
ELIWM	ELINOR
YLSARAH	SARAM
MY1YCPH1VLIRYHUVTUWJY	CHIRAT
CPVLARA	CLARA
M1DIHAH	DINAH
0M0RI0NVYVIYYIV	DORION
MFHLKKLLIVY	AHIHRI
W6YL1N1YRNCJTLAN	JEAN-ERMESTIAN
LMLDI1FYNFBA	DIEYNEBA
F1ILAWY5LELV7VLHIYY	LANGEVIN
JMLYDUHGYCYPPYIY	DUBEL
PLAW	PLAN
AGYTHE	AGATHE
HPERHRJW	PERRIN
WLSCHULYTESP	SCHOLTES
T0Y	TOM
L0YL	LOIC
LUKAJ	LUKAS
WMMWELHUHY65YX	COME
MW1YGMRIEVJWEV2K0UTT0U	GRENEROT
M10SLAR	OSCAR
BMLASC0PV1PYGVY	BLASCO
WF0KTIERYVYYTV	FORTIER
2RIGEHT	PRIGENT
WMKWMMNELM	REDWANE
MYLHPALLYLYELN79YYN	MALLEM
Y1T1RHE11YH	TROTTER
WYLYMYAPVUEIIYTVYVVV	MAUGET
APPPKRM	AKRAM
EL0I	ELOI
5AKTIAVA	SANTIANA
GILLIG1B6LLANHR	GILLI - BELLANGER
MPWY0	THEO
M50UTIFPPYYY	SOUTIF
WRAUD	GIRAUD
PAUL	PAUL
YLPCHAYUYSY5YYGYYY	CHAUSSY
GI1F1I101N1AILHHWLM	FIONA
VWIMTYGY	VINCENT
MALERVT	MAIGROT
RIEE5E	REESE
Y1AFATHE	AGATHE
LM1EHNKYP1	ENNAM
MIFTARD	TETARD
ML0PEZLYYYYYVVY	LOPEZ
M1LIWKN	ENZO
R7TSCH	RITSCH
H0HADDEB	MOHADDEB
W6BLLX	ALIX
EWVAN	EVAN
WLNDTHAN	NATHAN
DEPAEPE	DEPAEPE
LJAHI	DJADI
LPLMAEL	MAEL
NWMAUMRWIWE1NM	HAURINE
RDSAHW	ROSIAN
EWHELMANW	ENGELMANN
HANE0	MATTEO
WWLMDMD1CUU5HHDTWNHL51I	UNREADABLE
CARLA	CARLA
LENA	LENA
SVAW	SAN
QINEUT	BARBUT
WM1YWC0LUVRHDYUEI0YU0J	COURDEAU
MWWAEMLWNW	MAEL
Y1PERYGKYLHYSYYYY	PERKINS
GADRYEL	GABRIEL
ELWAW	EWAN
FERRAQU	FERRAND
IYWL0WA	ILONA
MWLUJAWEAW	LUCIE
IHILL	CHILE
W1LEYYMYARSYY0	LE BARS
CVLLALWE	GUILAINE
MBDEHNERPVYGIYYV	BOEGNER
2EFEUVRE	LEFENUURE
MWYMKHWSENW	MATISSE
L0PE5	LOPES
HERVE	HERVE
AWEVAHNJHW	EVAN
W1MWYYWVYYYLP	MORGEN
GLFCUFT	GASQUET
HAUYHAA	NAUSICAA
MWRD3NEQNW	ROSE
HMYABYAYLDYYHJ6WYYV	CABALO
LUUII5C	LOUISE
M1JWNNE	JEANNE
M6THIRAND	THIBAUR
WLES	JULES
MAHGM	MARGOT
VYAISS5ERE	VAISSIEAE
WIYEI	AXEL
EW	EMMA
YINN	YANN
LALIE	LALIE
P1LHIW	LISA
YZLIA	MELIA
ALDRIEH	ADRIEN
SIATLHE	SATINE
DYUPMT	DUPONT
W1PHILIPPLIWE1L	PHILIPPINE
MLELC1SE	ELOISE
LCUISE	LOUISE
MLMKYFRY0YYYYYY	MONFROY
BEXEZRA	BENEZRA
WML1SKTALFYWMANJC0A1I	STEPHANE
WWLMWILT10K1Y3IL3BL1Y1JMJL1L	FREIRA-LAMPALO
LP1TNEUPHHHE	THEOPHANE
WLMATTHLEU	MATTHIEW
MWZILEYP	BAZILE
VARD	VARD
YTPD0DVAPJRTVYVYV	BODART
HLFA	CELIA
LZ1A1LHAEHIDH1AN11NMLLW	HEHDI
YTYALSAR	YASAR
LZ1I1AIMAEJLLFEJHNHNWLIM	AMELIE
AMHWSUN	ANDANSON
KASTIZH	BASTIEN
P1HELI55A	MELISSA
MJCLHR1SSE	CLARISSE
REML	REMI
MWYULLVYGU	DARSLAM
LR0CHZK	CROCHET
DMHFFUNV1LCK	DASSONVILLE
G0WCALLK5	GONCALVES
Y1HAXEWCE	MAXENEE
LMAF0URCAYDEVMLYP0YRYTYY	LAFOURCADE-PORT
MY1YLEYVCY0MVHTEVP	LECOMTE
MYVSYJAMQYXA	MOUSSA
LJ5A	LISA
DEL1ESTHKG	DEVESTANG
MAXANCIQ	MAXANCE
PEMPURE	DEMPURE
QVEHT1H	QUENTIN
AUZELY	AUZELY
EMMISMAWNW	ELSA
PL1B1AHPITHIISTE1HMIM	BAPTISTE
MLMELANIE	MELANIE
MATH1LDE	MATHILDE
R0DIN	ROBIN
LY1CHHSNGWR	CHASTAGNOL
LLLC	MAELLE
WMILMARTYYYYVVY	WILMART
JM6B0UVTY0TPY	BOUTOT
MHH1AUT04INEHWIH	ANTOINE
JULES	JULES
M1EWY	EDDY
WLWHIHWL	SHIREL
MDHRHEDRLL	MOHAMEDALI
JUSTIN	JUSTIN
M1XRBJ	XABI
LARDEVR	LARDEUR
KWLJ1TJSHHHHHH	KAIS
DZHI5	DENIS
AKQES	ARLES
MY1YDPELLVV0MJC1ELRLYH	DELOMIER
HAL0	MALO
E1W70	ENZO
TMLSSH	TISSET
MY1YLYEGYTT7HYIE7CIVY	LE THIEC
AMANDYWE	AMANDINE
M1CAMLLE	CAMILLE
Y1LYWE	LYNE
M1YIN0H	HANON
5QNM	SANAA
KILVLFS	NICOLAS
BRIAND	BRIAND
N0RGANE	MORGANE
M1ESTHER	ESTHER
M1EBY0VHYLLLYEACVIIIJY	LEBOUHELLEC
PKREI	PERES
M1NHKTEIEYY	BARTELEMY
GQFIIH	GOFFIN
P1GAETAW	GAETAN
LHAWTEUR	CHANTEUR
WMMHETYVLWYJY	WERNET
L0U1L5E	LOUISE
RY0WDEL	ROBIDEL
HLIENE	JULIETTE
CLAK5H	CLARISSE
RW0KSWUYVVYL4PY	ROUSSEAU
W1CECL1LLLPL	CECILIA
NMLVENDRYELYYYGY	VENDRELY
HELIE	HELIE
MY1YZWEL5YI0IYUYVVJY	ZENOU
VMAMKAHDVUHAAVZPVK7EY	VANDECANDELAERE
VHWHAHAJMHEHH	VALENTINE
M1S0LPWE	SOLINE
WW5T1EN	BASTIEN
APISYLEEW	AISLEEN
HMYGNGYEYZYEVYY1CQWY7HL	KNEZEVIC
VLLRGIILC	VIRGILE
CAARIEL	GABRIEL
LWY1C1ALEYPENT	CLEMENT
JEANTET	JEANTET
MHHHHNJ	BENNANI
H1L3AYLDP0PVVIVIIY	BALDOVI
WSHAHA	SHANA
ZIZARD	ZIZARD
PMW1MAWIH0UHN	PIERRE-LOU
WNJAN11W	BENJAMIN
EM1RIJEHNA1RLDIIJNY	RENARD
DWELECR07XYYYYYY	DELECROIX
LY1AWLWABEYLLEH	ANNABELLE
WHREK	KUBEREK
MYTYGP0LBVRVLQPNUYTW	GOBRON
KAWEZHIJHHHW	KAZIAH
PAUL	PAUL
MW1MWBELGV0IWJVVJYG	BEGON
CW1DRI5SYI	DRISSI
DLLVA	OLIVA
M1IHALCEA	MIHALCEA
YPPJUL	PAUL
YFRYILL0N	MERMILLON
SZI1R	SEFIR
WMLRME	DELORME
M1LEA	LEA
CREMW	CREUSOT
LYAM	LYAM
EM	EMMA
MW1DWI6IDP2JBL0DFBNLL	PASCAL
MLAKARIC	ALARIC
DWENNEQVINYLLYPVY	DENNEQUIN
MLBA5TIEN	BASTIEN
MWLMWECIUVHVTLTJWYYN	SCHMTT
WMB0ISVYYGPGYD	DUBOIS
M1LWYREGCPHLTVIY	LYBRECHT
BMHRBEYVVYYYVNI	BARBE
JMCHLJ0HEJL	CHLOE
PMM0PWLALDZN0UYJVWYII	POPLAIN
EMMRRMNWNNM	ERENA
THMAG	THOMAS
BE5HIN	BESAIN
5UW	SUUA
IMY1YWNWIVHVD0I	DAUMONT
A1ANHEFLUCIE	ANNE- LUCIE
YARQU1S	MARQUIS
MLY0RCHAN	MORGHAN
DESSED	DESSED
M1KARCEL1LWE	PARCELINE
60KA	GORA
DMEBWLRLE	DEBOUVRIE
RENAULTL	RENAULT
HMWMYDYYPVFDUTUJD	HARDY
Z11LJLUCLIIIECRHJNMLIM	JULIE
TMPPIMYYNYITYYPYPIPY	TIMENTIT
FREHL0WD	FREHOND
BRULE	BRULE
M1TDM	TOM
MAUD1S50YLPYGYY	AUDISSO
MAWRTMHWURAW	ARTHUR
MW1YPW01UNJC0MEVWL0XL	PONCHEL
AWURELIM	AURELIEN
BR0SSE	BROSSE
CWJI	EVE
GEKECHE51	GENECHESI
C0RREGE	CORREGE
P1AWD0UL	AMADOU
3AVTE	PLIUTE
LM1L0RALJNE	LORALINE
BYYEMILLE	BERTILLE
Y1PGUYJVFLV0PUPVDYY	GUILLOUD
AHT0LHE	ANTOINE
PYM	PERES
MMNMNIWYENM	MAXIME
FKKVIEHE	BREVIERE
HWLBQUVY	ALBQUN
DARBLADE	DARBLADE
P0G0DALLA	POGODALLA
MW1YWGEJUEJRYERUYYJK	GERBER
MPLYDYNYHJJYQ7JV	DAH
RUWI	RUBEN
L0PIPAY	LOLA
S0LENE	SOLENE
JWLYDEMYDPUVLVLKVUFY	DEMOULIAS
VNDMH	COMTE
HLUTH2	LUTZ
CLADWGEL	OUADFEL
MWWMWNW	THOMAS
Y1LCYLLL0T	IOLLOT
LMEWIHYGYYYYY	LE LOCH
LUC05	LUCOS
MW1MKWALUDJ0YUZNWTN	KADOUR
TERWHHDES	FERNANDES
IMP1YIYWYAYRYKYVAN0HH	INARRA
LISA	LISA
THIILFENLLLI	TIFFEN
W1YLATHUILLERE	LATHUILLERE
MS5ALKS	DESSALLES
MRIBESYYYVYW	RIBES
WMLEXMNW1NM	LENNY
LWWWMWMNMFY	CLUZKI
EHFUENTE	LAFUENTE
EMMH0	EMMA
DMLPLANEILLL1FS	PLANEILES
MLUD	MAUD
SAFT15TE	BAPTISTE
HMYYIYYKYAWYILLVYUJ	KAN
LER0UX	LE ROUX
L0PUYI50N	LOUISON
BRULE	BRULE
NAEL	MAEL
P1ALEXANDRE	ALEXANDRE
P1HLA1H1HA1VTLJ	MAHAUT
MLJADAULT	JADAULT
JMBZRLL	JRABIKI
MLSL1M0N	SIMON
ANASTAS1A	ANASTASIA
VL0LLEAV	VIOLLEAU
AKEL1E	AMELIE
LEDEL	LEBEL
RWWDMMAWINW	ROMAIN
ESTRUCH	ESTRUCH
CHL0E	CHLOE
DGELF055E	DELFOSSE
Y1CHARLALL	CLARA
CRS	CROS
5MYK	SIMSEK
Y6S0LEHHE	SOLENNE
AMWWIMTWAHWL	ANITA
WP	ZOMERAND
M1GAETAH	GAETAN
DMWU0NCWNW	DUOC
HY1YJYMLYYZNTNYGJUUI	JACINTO
YYP1YBYYELYLFBJNYHYYPY	BELLANGER
TMWN	THIEBAUT
CHL0E	CHLOE
M1BCWY	BENJY
IP1CHHRLCTTE	CHARLOTTE
M1PB0VDYILJLV0ITULY	BOUILLOT
HWJUHEIY	AUDREY
QM6RAHZAGYVYP	BERAHIA
NM1H3RUH	LEBRUN
AUDIH	AUDIN
Y1HKIZPLX	CAMILLE
LY1NIC0LAS	NICOLAS
FWIT1D1LPM	DIAS ITARTINS
PI1HEJLLLHNAHLHGHMAM	MELINA
LM6CECILE	CECILE
AMFHAGWUWH0UN	MAGNONHOUN
WLLEAMN6EL	LEANDRE
EMLAMYYIYYJYP	ELARD
D0UYTE11IMC	DOURRELIGNE
I1LEXIS	ALEXIS
YJ5VLX0IE	JULIE
WYLIXE	MAYLINE
P1NATHAJ	NATHAN
KY	KY
PRGNEUX	PAGNEUX
LLERMTIN	CLERENTIN
CHL0E	CHLOE
MLCHL0E	CHLOE
M1AHNNL1W	AORIEN
BUTERY	BUTERY
PERRINE	PERRINE
P1AUGUSTIN	AUGUSTIN
PERRIER	PERRIER
9MW0RMMWYRNM	SORAYA
TMH0LLYPYYYVP	THOLL
GALISSA1RE	GALISSAIRE
BY0LLM0	BOLLARO
EHW	ENZO
EYAH	EVAN
H1XAIL	MIXAIL
MWL0TNCWNW	LOIC
LM50CTAVE	OCTAVE
WMYWSKLUWBUJ	BOINSKI-DOBUS
QMERR0WW0PYYVP	PERRONNO
MWKNXMEGHCEHW	MAXENCE
MW1YRW0LVYEY7TV7CIW	BOYET
THE0	THEO
LMWLMDWCLNUNZ4JZXVW	PEGO
M1LEQ	LEO
M1VAYYEY	VAYE
WAXIIH	WAXIN
HMPTHYRPYLYUJWLQ0YC	HINRY
3CYEFFER	SCHEFFER
MW1MWA1LTV44HA2HTUJNYLUIL1	RIT HAMMOUN
WCL0T	RACLOT
50LLNE	SOLINE
HNHYH	MARTIN
WWIHU	CAHU
MBALDUCC1VYYPYIYY	BALDUCCI
JAJ0Y	JASON
WPYWEM	COUVERT
PREV2T	PREVOT
HECHE	FLECHE
LPEA	LEA
Y1B1AUDRLHY	BAUDRY
GA5FARD	GASPARD
IMY1YFYFLY0VRYHJYYN	FIORI
DUDNDIMYNVIFLLE	OUDOTDEDAINVILLE
M1LCUTCF	LOUIS
P1HATHE0	MATHEO
HERVE	HEVRE
RFXELHA	REXELLA
YLR0MALN	ROMAIN
M1BKH0FT	BENOIT
HATTHG1AS	MATTHIAS
MY1YFYRLVHNQ4FQVVI0SVN	FRANCOIS
LEMHYSUW	LEMASSON
M1LE0	LEO
IM1HQCQWKKR	HOCQUETTE
BARTHHE	BARTHEYE
MW1YWHA0UFCPEJUSAVVT	KAPPES
RE8EL	REBEL
AHLSAHE	ALGANE
P1ELISE	ELISE
5EWTYL	GENTIL
YYL1AH	YLIAN
YBFNZLIYD	BENZETGO
RMWEMALWNM	REMI
TMWNMWMW	TOM
LH1ILWAUNINN0TKNHHN1NW1IW	QUINTEN
LMEWYYVVILUV	LE COQ
SUZ4	SUZY
WWW2NHWMNM	WILLIAM
W1Y0UWESS	YOUNESS
KWRISTEH	KRISTEN
LAURINA	LAURINA
I	N
PLR0NWEAU	PIRONNEAU
KAHTHJKT	KAMINSKI
PHHR1EAL0U	MARIE-LOU
0YE6ARD1N	OEGARDIN
NMLPT0YFFPIYYERVYYP	TOFFIER
LL0U7SLJ	LOUIS
LP1MARG0I	MARGOT
WCWLEHMAENCEHW	CLEMENCE
RH1S0N	RAISON
WWMAWJAHH	MALO
LY1B0UTLLLL0HNL	BOUTILLOT
CAWDYCE	CANDICE
DIERRE	PIERRE
MWELIMNWANM	ELINA
ERDEH	ERDEM
W1YFKAN	YAKSAN
MLRQHAW	ROMAN
M1PDARYZYAGCVNNBY	DARZAC
GHZYPLDUS	AMBELOUIS
MP1YBP01UVRYV8DWNUVL	BOURBON
KLMHUCJKJJHHJL	LUCIE
IM1WEFY56KRWYRY	WEISGERBER
T5LHUFF	TSCHUPP
HERMET	HERMET
M0BN0	MORINO
AYT0INE	ANTOINE
CHATA9GHH	CHATAIGNER
FR0LIDEVAL	FROIDEVAL
TJIBERGHYEN	TIBERGHIEN
YIHI0H	MILLION
MWHARAL1GEHW	MARIE
PLMWSA	WENSSA
31FLCLK	BIRICIK
BQJI5H	BAPTISTE
Y1WGYYYIWGGKYZ0	ANCZYKOWSKI
TH0MA6	THOMAS
KMJSS0N	POISSON
M1LEA	LEA
EYTAN	EYTAN
MLETUHELIH	LE TUMELIN
NEWARD	MENARD
XYMPPH	KHEPPAD
M1LKC0RRE	LE CORRE
Y1PJARYWIYNPGVPL	JARDON
LUUZSE	LOUISE
YVANNA	YVANNA
PHHM	PHAM
Y1EH1L0LIIGLELH1HHH	ELOISE
GMCHULCRY4YP	SCHULER
BM0LEY	BOLEY
Y1HHA	SACHA
MW1MWDUITWYERTWTURYEJNFJ	DUTERTRE
MYG1YYDYYUVYELATVYV9I	DUVET
IAUL	PAUL
MW1YWWLWIQJHJJJY	DARCQ
MMR	SAMIR
1LNRN	IIARA
LY1LEAJHHI	LEA
Y1L0ANN	LOANN
VAHNTW	VALENTIN
YLLKNCUEHARD	ENGUEHARD
Y1LLLWPWJLNHINNW1IW	LAURA
UA5RIEL	GABRIEL
QM1DE5GGRANGEYFY	DESGRANGES
RMCU5SEAUYLPYYVYY	ROUSSEAU
M1WHESYLI	GOMES
LWAWL01SYPYPLYYY	LANGLOIS
FLFAVVHLRQVC	FAUVARQUE
IWLLANA	ILLANA
YLC0LL0MBET	COLLOMBET
MLNW	NOA
MEWYRMFWLNW	GYRIL
BMGPR0YUYIYNYJJPQYGF	BROUTIN
MHWAEALQYSHW	MAELYS
P1AL0Y5	ALOYS
RAPHNCL	RAPHAEL
DATIL6KT	BATILLET
MWLMWM0FKAL2YKJVVY	NOEL
L0N	ION
WMWAWKWE0W	MATHEO
CATE116WE	CATEIGNE
BACTLCW	BASTIEN
5ESLZAG	DESLIAS
AVMRK	AURORE
ZMBJBL	ZERBIB
HERWVG	MERZOUG
JLB0NQLF	BONO
HAR6AAVRELE	MARI AURELE
WMHLANCKEVRPVAHJAU	VANLANCKER
VMLDUVAL	DUVAL
GL0IIRE	GLOIRE
MMMARMTHMHUUWAWCWTVA	MARINHO DA COSTA
HANDN	MANON
FWHL0REAN	FLORIAN
LUCIE	LUCIE
JW1PP1VEQTYYYPNY	PIVET
JWWUSKTWINENW	JUSTINE
LWMHWJJHH	MARIN
HARTLN	HARTIN
HWGAIHYS	MATHYS
M1KLIFE	ELISE
LM1EWGUERRWD	ENGUERRANO
M1LINA	LINA
M1AYMERIL	AYMERIC
SQLENE	SOLEN
G1JANJP0IHYP	DANJOIN
R0B1LLHRV	ROBILLARD
GM1NLLAK0ENLAJ	LAKEL
WCELENA	CELENA
MWJ0AMDWAHSNM	JORDANS
EIMHNMJJJH1J	EMMA
M1V11CT0RSNE	VICTORINE
THE0	THEO
FLBM	ALBAN
F1GILBCYT	GILBERT
LMARFTYYVYVY1	LARFI
W1WALLDL	WALID
MP1YGYEYVNTVVEVUVIZVFN	GENTEUIL
VALEWLH	VALENTIN
PASCAUN	PASCUAUD
IM1DASILVAIRFTHNF	DASILVACRETANG
CEYT15TE	BAPTISTE
ZFFZH	AARON
ALLRLHC	ALLACHE
JM1LRL05YIYPYYF	RIOS
P1ERWHN	ERWAN
MY1YCW00YNLAVVVVJY	COSTA
MLLIDVYLVPINIY7VP	POUILLY
SPI0HYCW	SIMON
Y6SDUGRJCYKYYYY	SOURICE
WYY1LFAYWFERPYGY	GARNIER
M1LECHEWADEYC	LE CHENADE
WMIFAUXVGYYPP	GOFFAUX
LL0UET	CLOVET
FRAHYQH5	FRANCOIS
NW6ST0YRPCH4LYVY	STORCHI
MYP1YMYYACYHPUYLVPVY	MACHOT
YMMMWRNM	SYWAR
B0NNET	BONNET
ZAUCIM	AUDRY
MWRRNFAUGHW	MARIUS
ACW1HHFJYKWCL1H	CHARLENE
HLWEANM0	LEANDRO
M1L0LA	LOLA
M1MSHYIERYYI	GASNIER
HATHEC	MATHEO
NHXEHCK	MAXENCE
5TEFXN	STEFAN
KLHLAW	KILIAN
MLSAFDALTAIIER	SADATIER
EFHNDM0UCIW	GRANDMOUGIN
C0RENT1IN	CORENTIN
PLR0Y	ROY
MHTHE0	MATHEO
SALABERRY	SALABERRY
TANYUY	TANGUQ
MMYSYPYWPYKWLMH	KASPRZAK
0RAHGE	ORANGE
0HWCWAHNRJIHH	OCEANE
M0VHTRRI	MOKHTARI
PMRUVDST	PRUVOST
SAB0UREAU	SABOUREAU
L0WTTC	LORETTE
L0PE5	LOPES
P1IANILLE	CAMILLE
WZLAC1UJ	GLANIOS
REBA1LHE	REBAINE
MATHTS	MATHIS
HM1TIFXEZRHY	TEIXEIRA
MWLYWLAIVLVAYPNUYJV	LALA
M10PHIE	OPHELIE
EL151NLNE	ELISSALDE
M1PHILIPPIHE	PHILIPPINE
MY1IWMYYEYYY	DUMEY
HIHWILDA	MATILDA
HBHY	ADAM
W1TAWNIDL	TAWHID
CHMERE	COMMERE
JEAWWE	JEANNE
M1MDTJSSE	MATISSE
HVW1NNCHPIANTHW	VINCENT
CWLCT11LH	CLOTILDE
MMATHE0	MATHEO
TATTANA	TATIANA
BWURMU	BUREAU
GWMWNRWWNW	GEVORG
LY15ICYILYIAYYHDY	SICILIANO
IMLCANYAYRAYYG	CANARA
HMAUCHECDRNEY	HAUCHECORNE
RUBEN	RUBEN
PAUL	PAUL
AMLGRH1NE	MIGRAINE
L1W6LUC1HSUEBHR	LUCAS DE BAR
XATNIS	MATHIS
WIMICCW	MASCHA
HLKUVESYIWVHPVLY	GUESDON
M1LHARYLVAAYYYPI	HARLAY
PIRA	PIRA
FF1GN1FRZELL	GABRIEL
DMIXW	DORIAN
HW1PJH0YMITYLVYL	DHONDT
HLEXHNDRE	ALEXANDRE
NIC0LKS	NICOLAS
MLNAR10S	MARIOS
HHLLLE	MAELLE
LAWJLEJXH1SHHH	ALEXIS
MNNTQHX	MONTOUX
LEA	LEA
EHUA	EMMA
ZIAH	LIAN
MYLYWTHIW4VTTLGNVV	CICUTTA
HUDTAVT	HURTAUT
LMAUTIELYFYYP	LAUTIER
LHM1WIUZPB1ICKIIH	WIERBICKI
B0URRTEAU	BOURRIEAU
AYHELH	AMELIE
CWHAMLLER	CHARRIER
GJL1ENL1IISNAJLHHIHJ	ELISA
M1ALEXTA	ALEXIA
CLARA	CLARA
ZHAW7ZZ	ZURAWIEZ
WWMYYVYYVPP	RODA
BRLNGER	BRINGER
LEFEWRE	LEFEBVRE
MLLEDUIN	LE DUIN
LEGER	LEGER
HATRAS	MATRAS
MMM0HGWNNRHW	MORGANE
LMHLW1YGQQY	LAINC
KR1IST1LAN	KRISTIAN
LE0N	LEON
XM0SSIVFIYLYLP	ROSSI
WWPFLWC0YPKHE4PYPVVYV	WELCOMME
MLWUCMWNM	LUC
HARIE	MARIE
M1EYTFBAW	ESTEBAN
RYIJN00Z	RINBOT
L0REN30	LORENZO
JWWUSATW1NEHW	SUSTINE
HXHKCRY	HEMMERY
ALIX	ALIX
M1CJNDY	CINDY
YLNUZIL	NOEL
JQURDAZN	JOURDAIN
LW6VLWSHTH	VIBUSHAN
Y1R0NALN	RONAIN
RACIH	RACITI
MLHVRELIEH	AURELIEN
M1CLWHHLDE	CLOTHILDE
HLILCKH5	NICOLAS
ZMWWEMWWWLI1HXNM	GWENDOLINE
HP1YTYAPBYDKNYYAIY	FABRE
TWE1XEERAY2YLLN	TEIXEIRA
THAIS	THAIS
P1YBEVA	NEVA
CAWNCE	CANDICE
LEHUEAU	LEVETEAU
HM1QLCH0W	PICHON
M1HWATS	ANAIS
EHYA	EMMA
BALTISTE	BAPTISTE
WM1YMWFLAVVUVU4VYIL	MARY
FA1LAURK	LAURE
MAPRYGADX	MARGAUX
D0RIANA	DORIANA
MUPXHEAU	POUPINEAU
LPUCYYE	LUCIE
CMHMIX0	CHABOUX
ANDRE	ANDRE
RYAN	RYAN
P1HARIAK	MARIAH
WLYETTC	JULIETTE
MTTH0YH	THOMAS
LFWLG	LIGGEOIS
LMLMEJLYFYG	MESLI
WY11ETTE	JULIETTE
YLALYVEYGYYY	ALVES
Y1KH0IXHAHLELHHH	ROXANE
MYAM	ORIAME
M1AHHA	ANNA
GAWW	GAUBERT
SDPPYHIE	SOPHIE
WWIMLW7LNU1YJI0N0H7L63W1L	COUFEON
EHL0E	CHLOE
M6S0RAYA	SORAYA
M1UII1LYC	MAILYS
C0RWTLIW	CORENTIN
LY1PHMG	PATRY
50UAIDIBEMHZ0H	SOUAIDI BENKHLOU
PRADELLES	PRADELLES
WUH	LOUH
Y1IGUYJ0TY	GUIOT
HEVILL0N	REVILLON
VJCT0R	VICTOR
JMAC08YTPPLP	JACOB
M1AUT1SJLYERP	AUTISSIER
REMI	REMI
KLEXAXNRC	ALEXANDRE
HETHAN	BETHAN
MW1YWMILNVT7E7RV5YJTEJIJN	WINTERSTEIN
JM1IVAH0VIZCS	IVANOVICS
LM1JEAHHNEHLLIHHIH	JEANNE
VERW	VERRO
HXELLE	AXELLE
LLYLAHAH01S	ANANOS
MP1YMY0IVYYYNYLYYWPY	MOUMNI
H1CWZL	GICQUEL
MLHEVL3CW	NELSON
HAXXE0	HAZZEO
Y1ADLF1MJ	ADAM
CHAUH0W	CHAUMONT
SAMH	SARAH
M1MAEMAN	MARWAN
WCAHDICEII	CANDICE
Y1SERUYTYY	SEROT
MDELFJHE	MADELEINE
RMACHID	RACHID
FQCESPEHCER	FORCE SPENCER
HARC0ULYSSE	MARC-ULYSSE
LCWHELH1KLHHHLH	CELINE
FHC6HLETIER	PELLETIER
CHFRLCTTE	CHARLOTTE
MWMAAYGUHW	MAYOR
HYILHA	NIMA
MLEBELLEWVP4VYVIY	LE BELLEGO
MPAX	MAX
MM1MCMHJUQTJ0TU2YLZLLTX0T	CHATOVILLOT
DUBRWIL	DUBREUIL
RYT0LYE	ANTOINE
CMMHYMAWRANW	CHIARA
HMCHEZGYYPYYGY	MICHEL
HVMICJTH0HRHHJ	VICTOR
LMEWERC1YGYYGLH	LEQUERE
LY0EN	LYOEN
BRETAGW0LZE	BRETAGNOLLE
S0CH	SOLER
M1L0UIS	LOUIS
NPAYKX0	MATEO
M14YUYC0YDYVL8WWYY	LACOSTE
EPMHYANUELLE	EMMANUELLE
P1WIH0W	NINON
B0UCHER	BOUCHER
LIMP1YHY0PJYBPALYHQDJY	MOSBAH
GW1G11EYPERI1ILI	GEYER
HAWARMIEWNM	MARIE
CMHLEHMWEWTHW	CLEMENT
AM1PHIYKPIP5YYY	PHILIPS
CNMILLC	CAMILLE
WYRTRAYD	BERTRAND
VERHE	VERNE
LPYUPCIE	LUCIE
JJJ1LHIL5	CORBEILLE
TWHUNIXYYVPI	THUNIN
1MLELEA	ELEA
DIEGD	DIEGO
DM1HERVE	HERVE
NHULST	DHULST
JWLNAWLIN7	MANCINI
SUIHNJIN	DUGARDIN
Y1FABIW	GABIN
KFMRUGGE	VERBRUGGE
GWHET	GRASSET
LLYLJLULESLHHH	JULES
MILN	EMIN
YLR01HAWI	ROHAN
TMHAY5	THAIS
A1PAUL	PAUL
AHWIKEY	BAILLEY
HWLDKU0YPYAPGYXSY	DRU-PAGES
YHYQ50RC	AURORE
IM1PLEYNAPYJY2EIYLV	LEMAIRE
M1ALEXANDRA	ALEXANDRA
FLPHULIHE	PAULINE
SCKWENWVCKER	SONNENDRUCKER
HDWEHE	HORTENSE
LWYLYHYPYSSLELVIILI	CASSE
MHU5LR	WINDSOR
EMWLVN1WREHW	ELVIRE
BW0NWET	BONNET
MPLYGYMYUVGHYYZYYY	GONZALEZ
AURELIIN	AURELIEN
YPLYHYYY7YY0JYUVHYFJI	TAZIOUNI
HW6YNAVLRYEYYVYIY	MAIRE
MIMAN0N	MANON
Y1THMAI	THOMAS
M1QUEHT1W	QUENTIN
W1LF0NLE	LEONIE
KERVFH	KERVIL
AAUL	PAUL
NARINH0	MARINHO
SYLVAIW	SYLVAIN
CMWHMAWLYNW	CHARLY
JEJINEVR	DESIMEUA
LNHAFRE	LOTHAIRE
WMLMW11NDPGSQPNQ5D4U	U
DCEGNE	OCEANE
PLWRE0LDUIS	PIERRE-LOVIS
1Y1RLMLEIHJIA	ROBERTET
MMMARKIWEALEANM	MARIE-LEA
HENLFYND1	DAMIENS
LY1K10HWLILLHSKL	KOWALSKI
NAYH	NAIH
YYYGY6YKYYVYQIUEWYGFS	DEVARENNES
PYP14YRYY0YUYESYFYHYYY	ROUSSIN
MHWAEKLWENNNM	MAELENN
IWLDEVAUD	DEVAUD
EL10T	ELIOT
NPY0GLHAW	NOLHAN
P0NCH0H	PONCHON
SAVDM0UTD10U	SAIDMOUTOIOU
LM1LEEHH	LEENA
Y0PHIA	SOPHIA
JPHE0D0KE	THEODORE
50ULR0NL	SOURON
LM1CAMJLLE	CAMILLE
DID0UH	DIOOUH
JM1IBYYAYVSPSYVDYYIYY	BAUSSON
THE0	THEO
M1PAUL	PAUL
WERMWUV	GHERMAONI
AGPAGTYHE	AGATHE
CMWHLM0WEHW	CHLONE
PRLAM	PRIAM
Y1GALIGIAZP0W	GALIGAZON
FRANCI	FRANCI
J0ULIN	JOULIN
BLA1R	BLAIR
SAMH	SARAH
P1CLARA	CLARA
WMI	RESO
54LUIE	SYLVIE
TMYPUYRYH0YYVY6YJUYY	JOURNO
YFCHANTYEUQ	CHANTEUR
WFLN1	WITT
DUCLERE	DUCLERE
HMFRVW14W3PNHF	MIEPOT VAODON
WW6REKCW0FRENW	GREGOIRE
MYLYAPSYSV0LWYIYCVNYVVLL	ASSONION
S0U0WA	SOHONA
THE0	TEO
FMNWARTVYYVLPLY	FROCHART
LY1PH0ENYYY	HOEN
DFRCE	DARCE
MW1MWHALTVHQIYNSVJPY	MATHIS
M1Y1IARHP	VIARD
MALAPEL	MALAPEL
HU60	HUGO
LUKAS	LUKAS
YL6ALDIHAIPNKAWNH1HMIM	ADRIEN
L0VNA	LOUNA
EYHPHA	EMMA
JV11FT7E	JULIETTE
EWWLIK0WTTAM	ELIOTT
HUHWG	HUANG
GMFRHYKYYGLYVPY	GIRNYK
1MYP1YLYAYFVFVTHTVTVVEIN	LAFFITTE
Y1LLEL0LI	LEO
MLTNIEC	RAGEOT
WWAN1	RAYAN
MLSARAH	SARAH
P1LRREPMARC	PIERRE-MARO
PYY1YYCPYDUYLY0YUVRAT	COULOUVRAT
DETCHEYSAHAR	DETCHESSAHAR
MLJULL01MF	JULIEN
I0RH0W	CORHON
THRLSTAW	TRISTAN
1LTI100IT	HANESSHI
TMREB0UX	TREBOUX
M1YA3MJWE	YASMINE
M1KCLN2IH	ROMAIN
LAURE	LAURE
HHARL0J	CHARLOT
Y18LABIH	BABIN
JWWDAKHWNW	JOAH
AHT0HZH	ANTONIN
MMLKW	FOLASTRE
WR0KQHE	ROMANE
LYE5	LYES
MATYIEWI	MATHIEU
P1HALTH1EU	MATHIEU
LYLFFQU1C	FPAVIE
MHRHAN0HWVLLLILY	FERNANDEZ
BMGZZMUHYYPPYAYY	BEZZAOUYA
FWLLEC0UVEY	LECOUVEY
BARBET	BARBET
RCUSSMU	ROUSSEAU
HYY14RHNY6WVULVIGY	RANNOU
NVIJAKI	NIJAKI
MLBDLLLIK1KH	BOLLIER
YLMAXYHE	MAXIME
PP1YCYY0UYRVTJGEYRUGVY	COURTEAU
UE0	LEO
IFLUVRHNT	DUPONT
PLCL0E	CLOE
SQLM0H	SIMON
KMINMDCWQ	KANMACHER
TR0ISPDUX	TROISPOUX
M1SXNAH	SARAH
WMLL	STOLL
MY1YPBI1RVRVAIBXHDYAJ	BERRABHA
CMWHWNWLEHENM	CHARLENE
MM6MWHNLWNRYDJCICIKJQJYII	BOUBESSFAU
BACEL	BACEL
HDCA5	HOUAS
JEWNEK	JENNER
MARIEH	MARIEM
MMALHKIGPYY	MALKI
M1CRLVETF	CALVET
DRWEML	DAVENEL
YLHEGDIL	HEGO
VYV	VIU
TAWEV0JJILAW	TADEVOSSIAN
FAYM	FANNY
M1JULIE	JULIE
M1WAHH	NATHAN
EYWANN	ERWANN
WHMHFWSNW	MATIS
EVA	EVA
CM1LL1VLNZINT	CLEMENT
H9X1INE	MAXIME
ALLPNH	ALLAN
LMLERIC	ERIC
Y1HHHATLHIELULL	HATHIEU
M1IV0YCLIUYFF	VOCCARI
GEGES	GEGES
Y1MATHIIAS	MATTHIAS
LLM1L1UICJLCLHLJI	LUCIC
XRJCCHV	BRICEAU
WWL	THIRIEZ
TYURIAULT	THURIAULT
YWAKAUAHJIAHGA	MAKAU-MIZANGA
IM6UELI1H	CELIK
BWERTA6WHYVP0PYP4	BERTAGNA
M1ANA	ANA
IM1DHLLALIY	DJELLALI
KMERVADECYNYIWY	KERVADEC
NM1PRAYTGHYBYUYYP	PRATABUY
RKQ	RECO
IIMY1Y0PRLY0JIIIALJNJXP	OROJIAN
HM1NT1YYIYGYYY	HINTZY
WI1MAY	SWIATHY
L0U	LOU
M1CHR0L1NK	CAROLINE
CMUDZW	CUOZZO
Y1L1NFNERMYIENLNLNELNMIM	FERIELLE
LNM1FAYTCLYYYPYYY	FARCY
JW5EAU	JOSSEAU
ALICIA	ALICIA
MLCAPUCLNE	CAPUCINE
YLVLLT0RIALHLHLH	VICTORIA
PATRJCE	PATRICE
M1K4VE	EVE
CQLIW	COLIN
W	NOA
IGM1PIHNJ1ITLIAIHMME	PETIT-HOMME
DCJH1IWTPCAN	DESAINTSEAN
KMUX	LEROUX
NHELLE	NAELLE
MN02ELYLYLGPYU	DOREL
DMELCPURTE	DELEPORTE
MY1YYFZ1YCWAJWPPJN	FICOT
M1EMA	LISA
MYLYKPAL5VIHVPJYC	MASIH
MLER0UXYYYVVVLL	LE ROUX
6AU1THFER	GAUTHIER
M6THED	THEO
Y1MATHILDHEHLHI	MATHILDE
CACHELEVX	CACHELEUX
HAWIFJJLH	EFE
BEWJAHIY	BENJAMIN
BLQUJ8K	BEAUDER
TMR0JAHIYYYYVY	TROJANI
FPPAYDIEN	FABIEN
IHYARA	CHIARA
YYPHEVA	MAEVA
M	VICTOIRE
HHEYA	MAEVA
M1JULFAHA	JULIANA
P1RLEKLS	NIELS
HAH0NI	HAMON
M1HATHE0	MATHEO
MLARTHUJ	ARTHUS
AWAUK	ANAELLE
PMAWE0WSKPI1VBYJLTI	PAWLOWSKI
HRHGDB	ARNODO
UMHHLKB0UXYYYYG	LAMBOLEY
EDEAH	EDERN
3WWWHNYL1FLYQ	BLANCHET
IM1P11TRA	PITRA
MJTULYF	TULIE
RPY0MAN	ROMAN
TMHEHMDVLVYLJPQ	THENARD
BYLANCHART	BLANCHART
F1A1AHA0RAG0ANUNXNLNM1IW	HARGAUX
MLYBRYI0PWTYYYYY	BRIOT
PAYEW1NEILF	PAYEN-NERLE
GMYESYLIPYHVVJVUVJJ	GESLIN
Y1HI0JWIHHHE3LIJIM	MOHAMED
XA5MIHA	XASMINA
HARQUESTERNANDES	MARQUES FERNANDES
L0UL1I	LOUIS
MWELENAWAW	ELEA
PPNTY	PATTY
MLSARAH	SARAH
KADD0UR	KADDOUR
GAFANCE	GARANCE
V6IPLHL0	VIEIPPE
APCLLLHE	APOLLINE
MHWJRHFJEHH	MARIE
RUFY	RUBY
P1V1CML0H	VICTOR
BILLI0TTE7	BILLIOTTET
BI1ZET	BIZET
P1TMMAS	THOMAS
MLAHWE	ANNE
M1MKC1N	ROMAIN
GM0DRAN0YY	GODRAN
HPELY0ISE	HELOISE
FHWYEI	PAUQUEI
CMHAUCHEWINY	CHAUCHEFOIN
MUHLR	BOUSBIA
LZMD9NE	LEMOINE
HYHQN	NINON
WLPTISYZPYUYTPEYVNY	MISZPUTEN
VALENTIW	VALENTIN
MWVHTWZTIYMWLVYWW	VATZIAS
LMW0UNYWSENW	LOUISE
Y1PHCURY0TI	MOUROT
GALYWW	GALINDO
MMLNL	DIMITRI
ANDREA	ANDREA
FMLLAYDV0NHV4NJVLV	AYDOGAN
MY1MRILVVIJHENAH5JTN	RIVIERE
KLLMAGTP7	BOUAFIA
TLVE0NHMI111	LEONTII
DU221LFK	QUARINE
GAUTHIER	GAUTHIER
HEST0RETMDUCHER	NESTORET-PUCHER
P1AIL1ELX11LSJI	ALEXIS
J0SEPH	JOSEPH
MP1YDYEYVCLRV0YQSVJY	DE CROOS
MFRAYANEL	RAYANE
LULH3	LUCAS
IMLJ0USEAU	JOUSEAU
ZJIYYIT	UNREADABLE
Y1GU11LGLL0UIV	GUILLOU
WP	DEVANNE
JM1PHHLP1PEYRYPPP	CARLIER
B1ANIHE	BADTISTE
PLPEYRRE	PIERRE
L0W5	LOUIS
FLAVLIE	FLAVIE
HEWW	GHERMAN
HYIPP0HYTE	HIPPOLYTE
MLRAPTLNC	BAPTISTE
FAVAER0HH	FAVREROCHEX
M1WDREH	ANDREA
TMMLYGWW	TEBOUL
0MMRYNAWNEAW	ORIANE
CUUL0U	GUILLOU
PEREGRA	PEREIRA
LR5NTER	LASNIER
YII16NZNCFLJJLHNNKWL0M	ZELIA
IFPMMC1G1BUIITU	HEMMER-BUURU
MWLLAMWNM	LEA
ANHJR	ARTHUR
CARL	CARL
LLMIMYIJ11IBAURE	DERAMBURE
YAPLEXNA	ALEXNA
ACHA1FRL0TTENM	CHARLOTTE
DMUB0WET	DUBOQUET
MW1YWLFLTUVJWFFJEYIJY	LETUFFE
DCULHVZJ	OCTAVS
51D	SID
DM1DELMAS	DELMAS
NW1IWVMYYYYLYY	BERNARD
H0WA1TJVG1AHW	OLIVIA
CHH1M0FHEF	CHRISTOPHER
WBEAHLIT	BERHILI
CY0IGNET	COIGNET
HW5DURY11PFGYY	DURIF
DENLD	DENIS
MD0U	DADOU
M1CHA1SL5LE11KAY	CHASSERAY
XMARDYMVVJV	HARDY
LEVILLAIN	LEVILLAIN
MYALAVAL	MALAVAL
T0URNTKR	TOURNIER
HIAYKA	MAINA
CMY0TYELLPPLYE1VJAJTYZN	COTELLE
LEWWY	LENNY
YHWAHTHILDE	MATHILDE
YGWACI7E	YACINE
HW51AILIEHH	ROSALIE
YYPLYMYYVGJMPWGVG	DURIEZ
CMHWE	CHLOE
YANI	YANI
JUST1WE	JUSTINE
WWPMYWPYMVU22YUBV	KARROAM
MAM2W	MARTIN
TRP7ERIE	TRAVERSE
HWYPIYFYBYWGYIEIRYHGVP	BOUYER
CM0RWER	CORDIER
MWLYCMH1VRTVTDIIYYYIN	CHATTI
WPELLEHYVI4VVPLW	PELLETERY
WBECAERTVJJVY01N	BICEART
M1BENJAM1N	BENJAMIN
CIT0W	BITON
AMYP1YFYYARYGYHAEYY0TYYY	FARGHEOT
FAIMAIXENT	MAIXENT
ECNEAZ	LE DEZ
MLLEA	LEA
M1TCM	TOM
IM1DA0CPHLAPRD4PY	BROCHARD
TIHE0	THEO
HILYTF1VK	ALYCIB
CLEHEWTZNE	CLEMENTINE
JES5EP	JESSEP
MAL0	MALO
F1GJAL1I	FABATIE
BMHS9WYYYYPYJIL	BRISSOT
IAMLL1F	CAMILLE
3HIGH0T	BIGOT
FV0UQUE	FOUQUE
IMLAL6HCUR	AICHOUR
LLKII11LJHTLCELSNNALNWIDM	JULES
WLWHWJLLLJLEHJLJ	CAMILLE
LMAS5AMCF	LASSAQUE
LPLHCHILHE	ACHILLE
LMW1YWYALRVQYYUVISNJJH	MARQUIS
MMMAUMDMW	MAUD
LHKKEHU	CHEREAU
TYH0MASKUDEQEK	THOMAS KUBEREK
SAVANHAH	SAVANNAH
TACHCW	TACHON
WWL0LNAWNW	LOLA
M1ELI0N	ELIOTT
PLYK1LSJ	WALD
WWWZGMWM	LAEBA
MW1YMAHIWDRLC0WY0W	ANDRE
WW1MBMELNVYA4IYCHTAJJV	BENAIGHA
LHETLTIA	LAETITIA
QFLLGHAJMNHWIW	LAURA
LY1LEPCTIT	LEPETIT
MM1YCWHLWIYQTULISYCUH	CHAPUIS
JM1LE8YEGUEY	LEBEGUE
AMWHEMLWIEAW	AMELIE
H0DY	HODY
YLIDRYEN	ADRIEN
RAFFHELA	RAFFAELA
QWMWANYWSNW	ANAIS
SLWL7VHW1EH1PHHHXEHLJ	SOULEIMANE
HLVMW	THOMAS
YWMMNWWXNM	YHANN
IMY1DYELFVFTIYWENUWX2IA0THIA0T	DEFFIEUX--THIROT
AMLLJEYY	ALLIE
ELLC1SE	ELOISE
JMLLLEVREYY	LIEVRE
FWR0QDU0WYDPYP	FROIDEFOND
HWAWAJTH5HHL1H	ANAIS
M1AXTHAJW	ARTHAUD
ANTDNIH	ANTONIN
EWMLE	ERTLE
MM1MWBILCUHTE4TUWYI	BOCHET
MLE5TEBAH	ESTEBAN
5PPAPWA	SANA
PL3LHNALA	SANAA
BMLHLR0N	BLAIRON
YIK1VELLL	EVE
LW1CIHD4	CINDA
BERNARD	BERNARD
HWMMJAEHH	BAPTISTE
PAUL	PAUL
THE0	THEO
FABKE	FABRE
Y11PLI2Y0YLIUYKYPJI	PIZOLAT
M1H7PP0CYTE	HIPPOLYTE
MSCAA	LASCAR
MMEMY	THEME
VALLEE	VALLEE
GJERAW	GERARD
AYRTHUR	ARTHUR
PIERRE	PIERRE
WWFABNZD0NM	FABIO
LMY1YPDELRVJNEJ5JLJLI	DERRES
NY0VRIMN	NOURIMEN
MLIRENE	IRENE
TYABARD	TABARD
FMWWETGPY	FOURQUET
YMENARF	MENARD
W1UHEK	DUCHENE
MNKS3A0VW	BEN MESSAOUD
XMMLNEWMNM	SELENA
M1WLIETTZ	JULIETTE
CMIYH6CMHYEH4UFYYYYY	CHARBONNEAU
MY1YCYALNYUADEVRPTVCC	CATTAERT
P1SILLA	SILIA
Y1BEWJAMLN	BENJAMIN
YPY1YTPYUVQLJJ1E4LRIVY	TUILIER
LP1LDAYNNFHVYAPIYY	DAMMAN
YJGE1RARDPY	GERARD
EL0UAHN	ELOUANN
MYLYWFA1VLLGVYLIVVH	FALL
NARLHAI5	MARCHAIS
HHMRMPWAHNW	MYRIAM
MP1YLYELVC0VREIUUR7EVRY	LE CREURER
YQ1BARTIW	MARTIN
M13IU1LGWN	EMPPTY
JML6EMPIYYLLYEPYTY	GENTILLET
0W1KJZEILH	KENZEM
SMYE5S2EHTVYYPYY	SMESSAERT
GMMCHCVM8YRELYAJVVY	CROCHEMORE
ALWJHAJYLSHJLJ	ANAIS
MSMWS	DESMOUS
M1MAEL	MAEL
ELLLDN	ELIOTT
HMWWI	AMINE
HLMWE	ALBANE
B0UHAD3AWJ	BOUHADHAOJ
TIH0THEE	TIMOTHEE
TWFALSELAYLYVYIVY	TSALSELA
MLCAUET	CAUET
P1JULES	JULES
DMMDE	DADDE
LLP1CIHLAY1JTHL6JLHWLA	CHRYSTAL
ATH2	ATTAR
DAVID	DAVID
M1KCHRAD	KONRAD
HNCE0	MACEO
NAN	ILAN
RYDDER	ROGER
H0MILLET	MONTILLET
LIC0	RICO
HEKBIKFT	HERBINET
TWCHHYNAXWI	TCHAKMAKOSI
MYYVID	DAVID
CEC1LE	CECILE
BELADGHAY	BELADGHAM
WWNYM3LLVA	GONES DA SILVA
WWNNET0N	BONNETON
BHWAMARHMEDAMHEH	BADR-EDDINE
CHERIFI0	CHERIFI
ZE	ZOE
BRUY4S	BROYAS
EWN0UARI	ENNOUARI
LHEW	CHEN
MW1MWWI5VYXUVTVLIF	BOS
EHVALHLH	EVA
MLIHL0E	CHLOE
MPFYCYYHYV0VUHL4GTNF	CHOUIN
AULELLEN	AURELILN
S7ZSH	SIMON
JMMDJW0UIWADIEUNJEYYY23D	IDJOUADIENE
J0SE1PH1NE	JOSEPMINE
R0ULLEAU	ROULLEAU
VJCT0R	VICTOR
APWLICE	ALICE
WGFL0ARGLGNHH	FLORIAN
AMHUCV	AMAURY
L0UIS	LOUIS
LMER0HJVYYYPVY	CERONI
M1IDRI55L	IDRISS
M1YYERYNYEAUG	YVERNEAU
31N0HAHEDIAZFAR0UK	MOHAMED-ALFAROAK
NAGUER	NAGUER
M1S0WZA	SONIA
ILEMENT1YZ	CLEMENTINE
YTCLEYEWNE	CLEMENTINE
REGIN	REGIN
MP1YUYRLVBANJIHWUYI	URBAIN
NAKY	MAQY
HHYLIS	MAYLIS
MLEAT1YATA	FATIMATA
LHMM0MAEAHW	COME
M1K1ILL1LAW	KILLIAN
JMWASS0N	MASSON
FE1BRE	FEIGRE
WCWAPHUWCINEHW	CAPUCINE
WLIE	JULIE
CHLDE	CHLOE
WETR0S	QUEIROS
LFNYAN	BRAYAN
CLEHEME	CLEMENCE
Y0UHSY	YOUNSY
WLPBR1Y3VCPUNYLWYPY	BRIDOUX
LHDC2HHYE5	DESHAYES
KMAHJEI2IYPEY	JEANPHILIPPE
MAEL	MAEL
MMX0NEJ4YYYYYAVY	FOXONET
LAURA	LAURA
PY1YWYYVRUISWVHWH	KORUS
BW0UK0U	BOUAOU
CWMANMWLLENM	CAMILLE
WLULAG	LUCAS
MMLMCW02URYBLEWLYYYFLL	LORBEL
WNMM	MAGNIEZ
CMLNTEUAE	COINTEDAS
WMI10LASYJYYIAGL	NICOLAS
P1HV5T1LH	AUSTIN
HYH0U	ZHOU
MWUHLHYYYA4YYYY	BOUALAN
VAYLE	VASSE
THDYA5	THOMAS
M1YELLIS5A	MELISSA
MPRPAYH	SARAH
TYBUHBA	MBUMBA
EYE	EVE
LMWLMM0E1MV0EYT6TAJF7TFT	DEMOTTAZ
GU21LST	GUILLET
KWIZARRYAF77VLYJ	DE IZARRA
LFIMCG	LE COCA
AMARF	AMARA
MWMATNAAYHW	NATAN
CLNRH	CLARA
JAM	JADE
5ULWET	GUINET
PAIULA1WE	PAULINE
DMELAS5HYLEVYPYVYPP	DELASSALLE
J5AURE	ISAURE
LMA15NEIY	LAISNE
MMYTYERLYP0HVJ7YUNW	OSTERCOH
3FTTY	BETTY
LMABRUYEREY	LABRUYERE
MMMDKDWYNW	MADDY
NNDI15	ANAIS
JLWHAKJHLLHHHJ	JANELL
WLWEI0HAHW	LEO
REYDELLET	REYDELLET
LM1DJE1SNI0HS11	DESNOS
PMWYKDNYYY	PLASON
LETL6LN	LETICIA
YLL1LIEIHNNHHHNHJH	LEA
Y1TRAHL	TURAN
FL0RIME	FLORINE
CFWMLA1JF	CANTAIS
IM6MHLY0ULY	BAHLOUL
J0BJE	JOBIE
MANFE	MANFE
HAPHAEL	RAPHAEL
HHLHH	NACIM
LMJSLALNMHIHHLL	SACMA
PAUL	PAUL
LER0SY	LEROUX
P1AJLICN	AJAIEM
YF1WHLRHIERH	POIRIER
M1AYWEHN	AYWENN
BF3HQIN	BESAIN
CHAHAW0N	CHASSAGNON
HLWLEJMJEWTHLJ	CLEMENT
M1ILN1NNHHU1ISLAINNWIM	ANAIS
M1GA5PARD	GASPARD
MM	THIOT
5HIRCE	SHIREL
ULYSSE	ULYSSE
MP1Y4YAYVWWYY01JUULPUEF	HADJ YOUCEF
AALDYS	ALOIS
YILLEP0NTWX	VILLEPONTOUX
P1IL0N	PILON
MD	DOLD
LH0NHGQ	LONGO
RETNIL1E1V	RETALLEAU
CPL0YYSE	ELOYSE
VEECPSSQN	VERCASSON
WLEFEBFYREYP	LEFEJVRE
R0N1PIH	RONCIN
DMWUYERVUJLWU7N	DUDUYER
M1Y0LYHE	SOLYNE
MLYJRI0H	MARION
YP1YYLYAYVMYJPVVJ7J	LAMY
AL1AW	ALAN
LGLY0WTIWN	MONTINA
HWIFER	JENNIFER
LYLPBLAVXITVMHYNYYH	BLANTRON
W10BAYYLLPYPYPP	OBAL
CLEHEH	CLEMENT
LY1BASTLDCW	BASTIDON
BWMAWWWLWIWVWTTGYX	BAUDOIN
WWIMDW010I161J3M565FK	BOULROT
CMHLAL	CHAHLAL
LHMHFHH0WHHHLJ	MANON
MNW0HAAWHNW	NORAH
KEV10H	KEVIN
HYWATNY0	MATTEO
M1NAD7H	NADIM
7LT0UAY	TITOUAN
WNAR0UHYYPYIYYI	MAROUN
PARHTA0V7DDL	PARAT--VIDAL
HATHAH	NATHAN
GM1NIC10LHP	NICOLAS
MBRE	AMBRE
IM6M0AAWAP	MORANA
YLVHLEYTLN	VALENTIN
CHHIUV1WEHU	CHAUVINEAU
CWUA2J05IB0UHY	COQUARD-SIBOUNI
HYLYSYAIKYYAIMYEYHUTI0N	SACRAMENTO
ALWK	ALLIK
WYWEYVPPV0WHYJVV	KOEV
MP1YCYAYDII40VVUVVUI	CADIOU
CLYAYRA	CLARA
Y1MARIHL	MARIN
BMGLLLEUX	BAILLEUX
BUR6ER	BURGER
CE5ARIE	CESARIE
LCWHHAJRJL0TTKHJ	CHARLOTTE
PNWE0HELEHE	ANNE-HELENE
CLARA	CLARA
WAMY	VIANNEY
P1HIHRHFHMAYLLNJHI	JEREMY
URATEAU	GRATEAU
LLMHELHILAJLHLH	LELIA
LKMHADJBJAD0JUHJ	KAGBADOU
ECUDJFHA	BOUDJEMA
EHILIF	EMILIE
IWWFWTJ	CLEMENET
MY1FWRIUFLLTTCI0JTJYL	FRELICOT
TQIQ9W0LS	TARAQUOIS
JULI4H	JULES
P1FLAVLLE	FLAVIE
JAIL60W	SAILLON
WLWJDJ1JINN1	RICARDO
ANWH	ANNA
GY0DARD	GODARD
M1RL01MLA1WHLLHHH	ROMAIN
3YUK0ULIH	DUMOULIN
UASSAWCKB	KASSANDKA
KERBNAT	KERBRAT
P1AHWE	ALINE
M1VALER1IAN	VALERIAN
QYVEHTLN	QUENTIN
WANGER	GARNGER
EMAH	EOGAR
1LYH	ILYAS
MMWC	AGOSSOU
MM1FARYIYH	FARDI
M1LUCIE	LUCIE
WJPC0UYZYYYWYYYP	COUZIN
HUNVIVJHVL4QIIY	COULIBALY
MW1MWWLIU0QHUWL0DI	BRIOUL
5WERREYVJJQY	SERRE
6MYDMYYNYYUGVVVJY	GOBIN
YAWI5	YANIS
SAUCH0T	BAUCHOT
IM1LBRAYJYVYYYPYY	BRAJI
C0REHIIN	CORENTIN
LHLARTHUR	ARTHUR
MY1YMYY0RYUINJVVDYC	MORIN
ZIANL	ZIANI
BRACCU	BRACCO
MAHEUT	MAHEUT
JEANNE	JEANNE
HATHUR	ARTHUR
HARII0	MARIO
PLLUCIE	LUCIE
C0NSTANCE	CONSTANCE
WES5LER	KESSLER
K1LYAH	KILYAN
MWLBGJYVHRYDLYPV	BAJARD
MAXEN3	MAXENS
AM	AXEL
IM1PPREAYUYXYYP	PREAUX
WLUMPH	KENTIN
HILULAE	NICULAE
SALMAN	SALMAN
ZCLH	ERIL
NIFI14N	DYLAN
HDY1HEYRAC	MOUNEYRAC
M1ECZ0	ENZO
MSCKL	PASCAL
DWAHLVA	DA SILVA
MMAND	MORAND
WLGRAYVY0VUYTWLVY	GRAVOUIL
NW1S0ULYAS	SOULAS
KYLIAHN	KYLIANN
WMUVG1LLEVAVWPP	HAUVILLE
N6UYEN	NGUYEN
M1MALIE	MALIE
LVHEUNEJL1FKT1PT	LHEUREUX PETIT
YTCAMILLL	CAMILLE
YAYLIS	MAYLIS
YSWCTEFAH	ESTEBAN
LEWH	LECONTE
GJJ1ULLJ1JENTHTIEIHLHLJ	JULIETTE
GMHAFFLW	GRAFFIN
MTTHLEV	MATTHIEU
CWALUTYLHVVIVG	CALUT
M1MATHI1NI	MATHILDE
L0ULJH	LOUISA
YLLWPT15TE	BAPTISTE
MLHBHAKLIHT	HOMBELINE
C0UDURIER	COUDURIER
WITNHN1N4AT	NORMANDIN
MLTL0HIAN	FLORIAN
AYEYL	AXEL
0CYEANE	OCEANE
VHIANLNEYHH	VIANNEY
LM1ULEM1	LENA
MHGER	DANGER
M1LL2AS	LUCAS
JADE	JADE
LYAVR1HE	LAURINE
QWWUEKNWTIKNM	QUENTIN
GWLLIWALEA	LINA LEA
ZLL1PNNERNRIJ1IHAEJHHWW	PERRINE
AWUBRYYYYP	AUBRY
5MWYYTWWNM	SIMON
HAU0	MAUD
BAYCW	BAYON
L0LA	LOLA
MTYILLYLYYYVYJV07TJ	TILLY
EHHA	EMMA
NAW0H	MANON
ANPDYRE	ANDRE
M1JPSE	JOSE
MLAMFERT	LAMBERT
MAEVA	MAEVA
BH1H	BHIH
WM6INAYGYGYYY	VAGINAY
MTMI1S	MINOIS
MMWARMZWENW	MARIE
HPAJY01B	NAJIB
TRL5MN	TRISTAN
IMLPNAJYPYIEREPYY	NAJBERG
YNYVSA	MUSA
Y1NILLFFERP	TAILLEFER
LY1JL0AHXNHALL1JJIW	JOANNA
MW0WERYKYGPYY	BOUNJERTE
IY1KEWYREPHL	REDUREAU
Y1IS0N	PISSON
MGYASYLPYPJ7NY6TI	GAS
RAPHAELLE	RAPHAELLE
CWAH11LLE	CAMILLE
LMLN0MS	THOMAS
MFJ0L1EW	JULICN
UWBRET0NYYYPYYY	LEBRETON
PENHEC	PENNEC
CHPEYLSEA	CHELSEA
HP1YYBEPVTVTAVNLPPPY	BETTAL
PKCJ	AREL
P1HATHYLDE	MATHYLDE
MM1MHWLIJULYIAJYDNYU0K	MILLARD
LF1WHTHCAR0UTE	OITACROUTE
WM1M7WU1WHIJDCWWJVPN	ZULIAN
JST2HG	JUSTINE
TMME0AWWNM	TEDDY
LUBIN	LUBIN
W1LAETJZTA	LAETIZIA
JEHANN0	JEHANNO
PEREIR4	PEREIRA
MWLYMBALVADLA0YNJIJC	GARDON
AUDREY	AUDREY
G0BET	GOBET
M1KAL0SSTK	VALOSSI
LH1	CETI
PARYS	PARIS
HEHLLIVAL0PEZ	HELILLI--LOPEZ
TUF61LV0	TUFFIGO
HM1PPAGVWI0IPWVUVA	PAGNON
IM1PEAWN7YEYRYY	ZANNIER
HY1NGUE	KINGUE
CMWHAMAWLCNNW	CHARLOTTE
J1WAFALA1L	WAFAA
NM1GREF0IRE	GREGOIRE
MLTFIN	LANDES
P1EUGEN1E	EUGENE
EWWRA	ENORA
FERRY	FERRY
M5AUBAUX	SAUBAUX
YLHIC0LAS	NICOLAS
RYNPWS	ANAIS
WTSSAL	WISSAL
HA1WMAWIH0	OTHMANE
MULLM	PAULINE
IM5YYVYYENYEYTYYYLGL	VENET
SIACK	SECK
P1HEAU	PINEAU
MLEM1ISVYYGYYVY	LE BRIS
M1LUCIE	LUCIE
L0LA	LOLA
MTM1MM0WTHENW	TI MOTHE
5M0L	SOL
1IMWLMIW21UCYI1YJJN2HYGN	ASD
TMFK1N	TEKIN
ANT0NE	ANTONE
CHARLYNZ	CHARLINE
JYWEAWNE	JEANNE
DTTTZ	DITTE
M1LDAAN	LOHAN
KWTH	KEVIN
MM1MBWAIURRW0UULZ0UH	BARROUL
WMILLFT	GUILLET
0EANT0NI	DEANTONI
SACHA	SACHA
M1AL11LE	ALICE
ML5EYAJHLEN	SEBASTIAN
INGVI	IRGUI
WMWADMNW1NW	NAOMI
KUZNETS0VA	KUZNETSOVA
YTPILLEF11CAHHHL	PILLER CAMMAL
LENMK	LE NOTRE
Y1CARSL1NE	CAROLINE
HARREAU	GARREAU
YAPNT0IIMZ	ANTOINE
ANYGE	ANGE
HMARC0N	MARCON
LMHJLLNEYPJUYYVU	CAILLOCE
ANME	ANAELE
THWAH1JBJHUTHLH	THIBAUT
BCWARD	BCNARD
AMLG0DYEUTYVVYAV	GODET
TSQW	TISON
MM1MRWJJV2DCAJNYUTUN	BIZEAU
PLFRZIM6	MAXIME
RYAD	RYAD
WADJA	NADIA
WYERHAUXR	OBERHAUSER
MELANIE	MELANIE
YWWMMWFASNM	MATHIAS
MHWRPREWIRAWT00JUUH	FERREIRA
WM6MWLA6VRRY07UIEUSJT	LARROUE
MLSACHA	SACHA
FMY1WRF0UWIISIDHYJ6I	BENJIO
FIESCHY	FIESCHI
WHWHMJHAJYJLHJLLJ	NATHAN
NJN0	NINO
AUBERT	AUBERT
MY1YRIGAVVHIVPYVY	RIANE
GW1WWYYLLYGY	MAYEUL
DANLCVILLZ	DANDEVILLE
WE5TA	CUESTA
EWZQ	ENZO
G0N	COM
MY1YNMUI6VE2YRJYDYJ	NUGER
H0RANGE	HORANGE
DWUISULWHVYYUV	GUIGUE
FMERRAHD	FERRAND
WA	LEA
B0UCHET	BOUCHET
HH1KHLFF	MAKHLAF
WYJEMI0VMYDWARYNWNY0VF	EL BARROUDI
MM5MW1C1TKIEKZH11CCF1IMICTL	JEMANISSIET
WMLMWHLDUGFJNNF21IJLH	MAUEROIS
H1EDLRS	NICOLAS
MM10PA3I0	DI-ORAZIO
LAURENT	LAURENT
DMUF0URVIYFPFYL	DUFOUR
LAUREWT	LAURENT
M1VI1AXWEY	VIANNEY
N1NA	NINA
B0NNET0EYNA2D	BONNET-EYMARD
REM0HD	REMOND
LMQHUSJIYLHYHHJ	QUSTY
CWIILNFNT	CLEMENT
1B1HYRLAM	MYRIAM
1PAIEN	ADRIEN
LMM1YHWYIEVCJKJLJJ7V	AYECH
AW1UXFZYYY	COME
HURTAVD	HURTAUD
H1AELYS	MAELYS
HWHHWEVCKLYYPY4Y	MEKHETTECHE
P1LTREYVPYYFYAHYYY	TREVISAN
WMLMTWD1CWINGDYT33H3NF1	UNREADABLE
MKLLE5R7W0	PELLEGRINO
M1R0HRHE	ROMANE
ML0I1TLIZ1	BATA
L0W6LN	LONGIN
PY116PYRP	PIGEYRE
ZE5HERAUD	DESHERAUD
HM1LNEYLGJNJYHYHJLU	NEIGNAN
WLADEU	ADEL
WYWTFR	LOUISE
HAWI	HADJI
BMETR8NC0YURYLTGYY	BETHANCOURT
GLQUELL0	GIQUELLO
LM6AL1ICE	ALICE
RICHARD	RICHARD
JMYP1YYKEYRVWLIJHYIJPH	MERLIN
CYAMU	CABAU
WHWJAHWHW	ROHAIN
5REC01PF	GREGOIRE
M6ILYAS	ILYAS
VAWGUN	VAWGON
GY0D0T	GODOT
NEFF	NEFF
SWCHANGYY	SCHANG
LM1SALLYY	SALL
WIRQW	VOIRON
EMER	OMER
L1AURW	LAURYN
AWAYUGU	AWAYOGO
MW1YNMKLKUEUWVSVVZJL	DEKENS
PLMAXLLNE	MAXIME
SLWLARHAHLHHHJ	SARAN
WW5K	COSTE
HPLYBYEYYRCIHGEWRYLVI	BERCHERY
CHWASJ5JANDRAHH	CASSANDRA
Y1GUIBJEKT	GUIBERT
M1MICHAEL	MICHAEL
HY1LY0YGVNV0JHYVWLV	LOGNON
W0IH	NOAR
W1BJSL1CFG	BASILE
WWMLCWLRNM	ALICIA
AM13ALLPEYP	SALLE
LA1CLARA	CLARA
M1NAEVA	MAEUA
NW12EH0IINEG	LEMOINE
MATHIEU	MATHIEU
K0C	KOC
DHYW	DAIM
LHLUE	CHLOE
HARTY	MARTY
MWYPPYYTVY6YYVW	BIGOT
H0YS	HOYS
TLWUHLJ	TANIA
WWLMWRD1QWTN5U8G2E	BORTN
B0URDAREL	BOURDAREL
AMLCHLRYFEYNTYZEPR	CHARPENTIER
W1EL0UAN	ELOUAN
P1RDWHHK	ROMANE
AW1YMVUMPDYYNJY	ROUAUD
M1TR1STAH	TRISTAN
L0IC	LOIC
CAL1XTE	CALIXTE
PJL0V1S	LOIS
TWWQHARGTHW	TAHER
WRDNSHLUDEH	BARON SALUDEN
MATTHIEU	MATTHIEU
IWPLYLYEGFVEJVWREJVIA	LEFEVRE
MXANR	ROXANE
MWLYWIR0AUYY2YJ0JYHX	IRANZO
LLARX	CLAQA
RAPHAEL	RAPHAEL
LEFEVREP	LEFEVRE
MYMYPPYVILYUJYL	COMPOS
PETREMEHT	PETREMENT
WAD0UACHI	WADOUACHI
ANGELD	ANGELO
FM05SEYYWVWGJ	FOSSEY
W1PDL	POL
MYAWZY	YAVUZ
CHARLEHE	CHARLENE
HAR1EH	MARIEM
WWLMDWD1UT6FYZUWLFF	PATEY
IM1FUFXN	RUFIN
MJALICE	ALICE
L1JIA1CLHIANAIKIDNTNTZHNWLNM	CHARLOTTE
T0YHY	TONY
BELHEUR	BECHENR
M1SYT	JUST
EMWL0MIQXNW	ELOISE
ESTWW	ESTABIN
WMFSSG	ANISSA
LNMLYFLLEB00D9EY	ELLEBOODE
MBYP0UYGFI0YVUUVYWY	BOUGIO
CDLHEA	CLECHET
MLWEYMAGNM	LEXA
HWMARNIWHENW	MARINE
HLWJHIHEHLH	JULIE
WMWHVIJVVJIV	DOGAN
WJDWE	ADJOUTE
M5TEPH14	STEPHAN
Y1DIANEL	DIANE
PMPATHIAS	MATHIAS
LMER0UXY4VYVJL	LEROUX
L1WWLYPM0IWVDTATRLJLYIFU4R	PONTARLIER
LE0H1E	LEONIE
NMEC0GNEYAV4UVJP	DECOGNE
MLWLC0LGS	NICOLAS
W1CMRAF	CLARA
Y1WIALEAHHL	EMILE
HEMYI	HERRY
JAW	SAN
H1PPLYERLSL0Y1PLLVAVXAY	PIERSON-LAVNAY
A16ATHE	AGATHE
SPPPVSYY	SUSY
REDCENT	REDCENT
ALIX	ALIX
MAXIME	MAXIME
JI1TNWJANN1HMLW	TOM
PPPXSC0	PASCO
DMAUYSSYYYVVVPVUV	DAUSSY
HHNEL	MANEL
BRILLIU7	BRILLAUD
CWULLAEIN	GOUARD
CHHLLLE	CAMILLE
YLHDUYA	LOUNA
LMPEW7IIYGM0MVJ7UPYUJ	LE MIGNON
DAJIC	PAJIC
LYLHCANGD	LINCANGO
WXI1J1L	UNREABLE
M1ELZYA	ELISA
MAKWE	MARINE
PAUC	PAUL
MLLAURE	LAURE
YLPM0NYTYAYGYNEYY	MONTAGNE
BWAUDY	BAUD
EMMLIMNWEAM	ELINE
YTPAUYBYERITVYVYY	AUBERT
ML5EF6CWT	SERGENT
CM1B0UHH1SP	BOURHIS
M1LPTLIIQI	ARTHUR
VMICWE	VIGNE
DUPQHT0R0UGIER	DUPONT-ROUGIER
LARRUCH0N	LARRUCHON
R0UEVX	ROUAUX
ENZ0	ENZO
VJG0T	VIGOT
LUCK	LUCAS
SIWHHMNJHLLH	SARAH
MBWAPNTWTSTENM	BAPTISTE
GM5VASYSYEY	VASSE
MW1YWIALUNNYDYY0B5DSL	BAUDRY
SAHRE	SARRE
B0MMAD0	BORDONADO
31NYL0KA5	NICOLAS
JJLIETTE	JULIETTE
YASIWE	YASSINE
S0ARES	SORRES
HERVEIIHLE	MERVEILLE
MY1YYD0LVUEJTJJYJJT	DOUET
TERN0I5	TERNOIS
WLNJHHJGLII	CORNAL
GMUIG0UYGLPYYGY	GUIGOU
CIL0E	CLOE
FEWFAWT	LENFANT
AZNCV	AENOR
VHWYHLLEGHEH	VAN MALLEGHEM
MPJ	REVET
WKWPYYPP	LANG
YNW0A	NOA
M6YFN1S	YANIS
PIELREL0VI5	PIERRE LOUIS
JM0WEWIYYVVH	JORGE
MVLRN5ER	BOULANGER
HIRRAHE2AWLDSADAT	MIRRAHEZANI-SADAT
HDR7SCH	MORISON
QBBID11FIWTUCC1	ABBID-PINTUCCI
Y1TEAWHE	JEANNE
D0R1AH	DORIAN
ZALEYHI	ZALESKI
IM1EIJ13T	ELIOT
HW1YAGULVILNLJYEYUDVNTTT	GUILLEMONT
MLWLYA	JULIA
MGRREPL0MEAU	CARRE-LORMEAU
YASAWTHHHWAN	VASAN THATHEVAN
LPLAGATHE	AGATHE
R0MAIW	ROMAIN
CMILK	CAMILLE
M66UERJNYY	GUERIN
3CWNYFSY	BONNEFOY
P9WL	PAUL
B0UTET	BOUTET
Y1YA55MINE	YASSMINE
BWR1SRFL	BRISARD
CH0QUET	CHOQUET
ELWH00JUARJLDJHLL	EDOUARD
ILWW	LUL
ADELFNE	ADELINE
P1GUHFJJ	GONZALO
HRN0N	MANON
THUREGUIBER2Y	JAUREGUIBERRY
TWMZNMWANM	TITIA
HHMAHY	HAMANN
CYWSAHDRA	CASSANDRA
ELUUHW	ELOUAN
HUGD	HUGO
HMYY0YMYYYYYYVVYYM	HOENIG
M1RKD0UHNF	REDOUANE
M1ZAKARYA	ZAKARYA
ELW	EL HARRAMI
BES5LN	BESSON
WPJYGYAYVUDYJIVNUIUY	GAUDIN
MLL0UYA	LOUNA
CELEWA	CELENA
HIM1LRIVCHUYARYDYYVF	RICHARD
DFUP0NT	DUPONT
ELIISH	ELISA
T1I1HL0IALWIEHLHIHMIW	LOANE
ALELYA	ACELYA
MPH1YLYYEGVWEDZQAGYYA	LEGEDZA
MFNW	ENZO
SMABRTIER	SABATIER
CMML7NUWELNM	SAMUEL
YLGAHLLAANLD	GALAND
HLLKJJN	KILLIAN
TMHUAVLTYIYYYI4	THUAULT
PPALAT	PPLAT
ARTHUR	ARTHUR
JARMAFCIYK	JARMARCZYK
UU	LOU
MMLMWHHFVAJKTYVUVVLL	LERAT
JEEL0D	LEELOO
HMMQJTYIYYYFYY	LECANU
ZLIL1NHU0GJD7000JW0M	HUGO
MART1W	MARTIN
AW9E1KELLKHA	ANGIE-KELLYSHA
MWL1YCW0LVURYAAWA0TJ0J	COURANT
MWLMPME1VCYUWVYRDYWT	PESCHARD
MYAGES	MAGES
JMAYID1ELYYEYGYWPYGY	DAVID ECHEGUT
ARNAUD	ARNAUD
LAMRY	LANDRY
H0ZAN	NOLAN
CC0N	LEON
LMWE0MWHWNW	LEONA
WME	COME
BLANCHN	BLANCHIN
M1CLFHENT	CLEMENT
M1CHL0E	CHLOE
PLALYCEA	ALYCEA
WH0N0RK	HONORE
M1NLTNLT	DUPREZ
VFCT0RFF	VICTORIA
CWMAKHFWLLEW	CAMILLE
LULHFTNG1IHAKU	HUCHET-GIRARD
MY6BP0LUVRYDP1LPNJ6Y	BOURDIN
MMYYWPPMEWWI	DELHOMME
KHFIV	NABIL
MLAHI	ANI
W1LLUZH3	NICOLAS
ALMANZX	ALMANZA
MMYY2YAYPVVDUWN	IEZZA
IMY1YLYY5Y3YF3AGKH5GPN	LEBBAKHAR
TWLEHEIJ	TREHEIN
MMWETYLVY4PYY	ANQUET
KP1LY1M	KILIAN
LA1TAHUUY	TANGUY
ELID	ECIO
B0UZ1D1	BOUZIDI
J1L0UNH	LOUNA
M1AHTH0NY	ANTHONY
CAMELLM	CANDELIER
YLLL0UID	LOUID
URWN	URCUN
PLMNA	ANNA
RMIBE1WYYYYYYG	RIBEIRO
DIDR1ANE	DORIANE
LM1WELYHE	EMELYNE
MW1YAMLLYAMYPARHGH0TTVY	ALAMARGOT
LKMDRT	LEMORT
PLHDAH	NOAH
TMFANW0UEZ	TRANVOUEZ
GMU1LLETYYLYYF	GUILLET
AHRID	ASTRID
P1VLLIICTCRL1LJL	VICTOR
W1YAXILY	YANIS
M1K0UYPVYEYLYAYSYYY	KOUVELAS
PL5ALA1	SALA
Y1CR0WWGYP	CROZON
MAWHANVWDIHENM	AMANDINE
FM1ICHYAMEFYY	ICHANTE
MAWDRMLIWWAM	ADRIEN
NW10HLEYRYYGYP	DALERY
5TAHLI	STAHLI
PNAADXAYMD	PITARD HAVARD
M16AUHIKR	GAUTHIER
BLHKE	BLAKE
SLIL06HAWA	SLILO CHAWA
MMCYHJTJTFYPYY	DUCHATIAV
PLEIL0LVLMALL	ELOVAN
Y1AAHPTRPPYPP	AAMIR
MP2ISFE	BAPTISTE
ZQE	ZOE
M1L5SA	LISA
LQM1WEYRYEY	QUERE
KUBLT	KUBIT
KMTLWYYYYVVPY	TETLEY
MI1LIER	MILLIER
AKAKP0	AKAKPO
WLAAURAEJLFEHH	AURELIE
TMWHDGNMASM	THOMAS
D11LCC	DIEGO
PMWLAINYIVGLVY	POULAIN
MWHA1QHW	KEVIN
HA1M0VWR	MAIMOUNA
AAV7EAN	MAUDEAN
YLILDYA	ILONA
MFL0RE5	FLORES
FHVV	PAUL
Y1IHFH	MICHEL
IM1KF7GIAMTLGEYRCPU7ALKI	KAZMIERCZAK
L0UENN	LOUENN
EMVA	EVA
FELIX	FELIX
DAMZ	DAME
MM1YTWHJCWENZLZUYK2T7NK	THEEBLYNCK
ELTSE	ELISE
ALMHDMJHH	ADAM
MN7TED	MATTEO
ABDELHEDI	ABO ELHEDI
C0REWTLN	CORENTIN
ADHIEN	ADRIEN
2ZA	LEA
HCQUEY	JACQUES
FH2AH	FARAH
ACWHIHAJRAHH	GHIARA
MLEMIIN	VALENTIN
WWLMHW01NU2QN2QTT3W2NPLL	GOURDAIN
HUGQ	HUGO
H0R0N	MORON
P1EN20	ENZO
LMAHDXHHNHHHJ	ADRIEN
PMERKY4YLTGYY	PERES
GUILHEM	GUILHEM
MPEREEPG	PERES
B0VRY	BOURY
MRWWNHWNW	RONAN
NE5FL0NE	NESRINE
TMWIFMJWAHEHW	TIDIANE
CATT0T	CATTOT
M1SLELBHHJTIJEAWHHH	SEBASTIEN
LYLH8WMWLL	MANON
C0TTEREAU	COTTEREAU
HPP4RI0N	MARION
PLALWENQ	ALWENA
B0URGUICNDN	BOURGUIGNON
LUCLE	LUCIE
HCUY	HOUY
YMAFNDR0N	MAINDRON
TH0M5	THOMAS
AKEM	ARSENE
FL0RJAN	FLORIAN
HWWXTKHWANW	NATHAN
L0ULLH0N	LOUICHON
CMRE60IRE	GREGOIRE
M1DJLHMHF0	DJANGO
MTAYCHA	AICHA
NM0UWLCR	MOUNIER
HATHILDE	MATHILDE
DWERVIELEYYYYYYY	DERVILLE
YELIZ	YELIZ
MPLYRYU1VHIAVYNPAN	ROCHA
G0BTNET	GOBINET
DM1RAPHAEL	RAPHAEL
PLFAB1EN	FABEIN
GMLDIELL1K1WHDIHY	DELANNOY
DMLN0H	NOE
FL0FEWTIN	FLORENTIN
DMVPRAT	DUPRAT
L3M	DIAS
GMUILHXRD1YXYYHWYKL	GUILMARD-SCHLICK
I7MM	PERRONE
CHABERT	CHABERT
WRETER	RETER
RPEGNAULT	REGNAULT
GILLIAH	GILLIAN
CWAHW	CAHEN
WM1IT7UI	ABTITOUI
AWAZLLE	ANAELLE
M1CHARL6NC	CHARLOTTE
TKHE10ANM	THEO
ANT01N5	ANTOINE
MYYPY1YYWYKYAIHDAYYYIIG	BAKANA
Y10SCAR	OSCAR
YJPULIETTE	JULIETTE
MHV1K1	MAXIME
EMYRIYHYC0YIRWEVYX4WY	GRINGOIRE
MPAVLHIH	PAULHAN
Z111NHIAKAIJ0NWAHJNMLCM	MARION
CMMYEYPVVYYUW4	COMTE
MLRFPUHALIIHF4	RAPHAELLE
PRAYSUNT	RASSENT
FRAHSD1S	FRANCOIS
JM1BERVWARYYDYG	BERNARD
AWW	ALEXANDRE
Z1I110CNLANRJA0NNLWL0AW	CLARA
MP1YCYHIV7LVAVKVVDYIV	CHILARD
MWLMML0LYPEGZYDYHWY	LOPEZ
YEWTAWAR	MENTASSER
PDYRDUL0U7	DROULOUT
C0CHE	COCHE
MLCHARL0TTE	CHARLOTTE
DEBERSE	DEBERSE
MJPWYWUM	GARON
MMTHI5	MATHIS
YILLHHKZ	RICHARD
JULIENNF	JULIENNE
MPHERYYLYPU	PAGER
THZ0TIME	THEOTIME
MP1YLYWYVBFSIVJTUI	LOUIS
YWA	YUNA
LGHLR0LDRIGUES	RODRIGUES
CM1ARNAVLLT	ARNAULT
H0PAY	NOA
PPTH0PS	PITHOIS
MLL0UIS	LOUIS
UPAGRYA	CLARA
WNZALEZ	GONZALEZ
VAHDAPELAR0HMT	VANDAPEL-RONDOT
MMWELM1WANM	MELIA
0RI2NE	ORIANE
FMRWENTINYLYJYVIP	FROMENTIN
ELH0UHI	ELMOUMI
WWWKWNW	ILEIDILLAH
LY14BLZLRHAIIWLH	YSEE
NAKU	MALO
MAKRUX	MARGAUX
MCHLIUFENM	CHOLE
CMCKHZAY	CORNEA
HPMIW	TIPHAINE
Y6CL0NSTLHWCEL	CONSTANCE
HWEAN	GAETAN
YSAAL0HE	SALOME
EECKUUTE	EECKOUTE
Y1KHMLIS	KHALIS
MHMLIH	ANNA
NYPYENNA	MIENNA
W	BRUN
M1ZER0UKI	ZEROUKI
MIYHAN	NATHAN
BMHRBELVJLYTUHF	BARBEL
LL0H5ERV	LLOISEAU
MM1MWW2LUZJNIIYE2IDKDYT	WOZIEZKO
BERTELLE	BERTELLE
MM1YGPILRWNJRIEIJWJ	GIROIRE
M1LEA	LEA
ILWKR	DE BACKER
M1LE6HHXD	LEONARD
YLPHUY1LLLV	VOISIN
AMT0H1FKIKDLLNIN	BION-KEROUEDAN
W1FANNY	FANNY
MF6UQUETYYYYJIPP	FOUQUET
FJFFIIYNHELIEI1	BORSES DEIINA
PUT1EFNP0URE	PUTIER - PURE
FHY0LLE	FAYOLLE
ELMUFAKKLR	EL MOUFAKKIR
S0LLNE	SOLINE
IY1PETLT	PETIT
M5EBAGWY0YVYY	SEBAG
LWJJIENGJ0HIH	DIEGO
DELLERBA	DELLERBA
LEMF1LRC	LEMAIRE
5MWALALGIEH1W11	SALLIE
RMAYAILH	RAFAILA
GMWABNRWKLNM	GABRIEL
RAKTVREAU	RAUTUREAU
BIAWCHET	BLANCHET
BEAUMI0W	BEAUMONT
AABWRD	AMBLARD
AMKKAYRWPPIVPY	AKKAYA
VERVAECKE	VERVAECKE
LUC11E	LUCIE
TYCMQS	THOMAS
L0U0AWW	LOU-ANN
LER0Y	LEROY
WY1YLYE1PVA4IYHVDYJN	LEPAIN
W	ARTHUR
C0RCWTLW	CORENTIN
ALYLLA	ALYCIA
H7C0LAS	NICOLAS
FELALIAT	BELALIAT
ALEXIS	ALEXIS
AFHE	AIME
EMWWMLJWENM	EMILSE
LM1AWT01YNE	ANTOINE
NWWCNRQWTHW	ELORENT
CLEMEXT	CLEMENT
NWPYY1YFBPY0VRVT0PTYYLNY	BORTOT
0MJPERHHJHY	PERNET
P1MAHRGAUX	MARGAUX
AMHCYYEYMYVAJYYGVV	ANCEAUX
M160NCYALYESVL	GONCALVES
BM0HT0VX	BONJOUR
MHMERJWJANHW	MERWAN
CHLHFH	GUILMEM
DWIEUSEYRE	DIEUSEYRE
HFLFM	MILENA
WMKRFP	ROGER
WH0N0RE0HVET	HONORE MUET
MHWATNTQEUHW	MATTEO
PALLLWD	PAILLAUD
5AYA1MRD	SAILLARD
CHARUI	CHARKI
F0UYUETRUU	FOUQUEREAU
WWLIF	NOELIE
LMYLYLYIYEVVLRLEYV7YY	LIEVRE
MWLYMDE1UHDEIVL0VVIV	DE MELO
LIHA	LINA
LMY1YMPI11YRVEWZYIVVI	PIREZ
M13RUNETEAU	BRUNETEAU
B0URWH	BOURBIA
TY0NPY	TOM
M1R0H1H	ROBIN
HYAH	RAYAN
TWMAN	TEOMAN
J0L7	JOLY
LEHTFNAGER	LEMENAGER
J1WSICA	JESSICA
M1CEDKILC	CEDRIC
GMU1LLLIMIYINIYFYVP	GUILLIRMIN
HH0	MAO
L0REWA	LORENA
LY1PRYLMWT	PRIMAUT
EEM	ELENA
YLBLELHLJIAMLINIILHHJ	DENJAMIN
A1NNE	ANNE
AURELIEN	AURELIEN
HMMMAI1WKNW	MARIE
Y1RCBJLNHLIHLH	ROBIN
S0CMRD1	SOCHARD
LAURENT	LAURENT
J1Y01HJHNYLE51	YOHANES
LMNCZEW	LANCIEN
KERUUE	KEROUE
Y1MPTII1STE	BAPTISTE
HLYS5IA	ALYSSIA
ACFELHS	ACCOLAS
JMWVLMESQNW	JULES
ETHHN	ETHAN
M1GUILLAYYE	GUILLAUME
TY0MBALLE	TOMBALLE
YMI1N0NVMYVVVY	PINON
AWIJNNHJUFHLH	ARTHUR
CW0HLMWYVVYGY	COLLAS
GFHRTHUK	ARTHUR
WWUDIH	GAUDIN
RDMAIN	ROMAIN
LENA1LW	LENAIN
Y1HUG0	HUGO
LY1CLAVDE	CLAUDE
NESBRI1	MESBRI
GMG0SGYIJYNV	DEGOS
LE0NIE	LEONIE
M1LIS0N	LISON
PMJ	PETIT
HMR5ENT	SERGENT
EGWIEM	CREMI EUX
MLMI	BENJAMIN
U5UBELLI	USUBELLI
M1MAHDH	MANON
M1YGY2MC	JHRDME
MLPA2YEWPHECVJ6YYVLI	LAZENNEC
NYAILLARD	MAILLARD
WMHRI0W	MARION
MHMNHNAWNM	ANNA
WSUP	YUSUF
DAUL1D	DAVID
LUCY	LUCY
HAYH	HAYETTE
CDRSELLE	CORSELLE
JANE	JADE
JADE	JADE
TCURLIHE	TOURINE
HMMELVVVFIYGP	NOUVEL
MMAW	MONCADA
WM	BOGOTTO
MRA	ENORA
YLCT23	VICTOR
WI1C0LAS	NICOLAS
GWERVAISP	GERUAIS
UENDAELE	VANDAELE
MF1YEYLY0WWY7EI7VUN	ELODIE
DUBDSC	DUBOSC
ZYIYU	ZHIYU
HDEM	ADEM
JULF1ETTE	JULIETTE
ELAAR0UANI	ELAAROUANI
PUHG	PUIG
YLCLERYL	CLERC
JGYUWCNE	JULIETTE
JHAN0L	IMANOL
JMBHHACQ	CABANACQ
M1EHILIE	EMILIE
LWPLYCYDPMYYSYPHYP	COLAS
V1NNHEY	VIANNEY
W1S0LENE	SOLENE
LMP1YEYSHYAVULKPTYJUY	ESNAULT
WW1MWQNIIU73YI1NY4W	ROLLIN
5ITELLAHHJ	STELLA
TD2TET	TORTET
CERIAV	MERIAU
AMNHKZLVNLTIPPYY	ANGELOTTI
AHDELLAHWHH	ADELAIDE
EYLN0VSSA0UI	ELMOUSSAOUI
LM1N0RA	NORA
MML0UMIWSENW	LOUISE
APPN5ELIQCE	ANGELIQUE
WKILLE	BAREILLE
MTTHE0	THEO
LG1B0HNEF0N7	BONNEFOND
HMMVETVVYVYVYU	HERVET
HARLE	MARIE
WMLMWNK1N1DYMIDTS5P7H	DEIRORTE
LUCIZ	LUCIE
IWWXFKNWENW	OXANE
FLCHANLG1YDN	CHANG-YON
FYPABLEN	FABIEN
LCMJLAJRHRLH	CLARA
MW1HEKPVE	HERVE
AMELCAL	AMELLAL
MWLYWGL09VPYPJY1P4JL	GLOPPE
YGLA	MILA
HMAH	MAEL
MM5YMCH1IH0TETIHJVJN	CHATEL
PADI0LLEAU	PADIOLLEAU
0CTAVE	OCTAVE
HAXH1JAJ	HAXHIJAJ
WMPEYWYMPYUZVTQJWWA	GUENDOUZ
HEMEWE	LEMOINE
MMADS0TYVLYIVVU	MASSOT
FIR7I0N	FIRPION
GPLYNYYHFWYYV	TRIOOX
WKWMEYIPLYGH	DEBOURSE
YLMIALELLLLEL	MAELLE
AMAUMIC	AMAUDRIC
HUICW	HUGO
M1WJF	IDRIS
PARENT	PARENT
ELLSE	ELISE
ZLL1HINWH1AAALLHWAW	SAVERIA
MY1YYFKVWIIHLZU4JVLNYA4P	FRUHRUFF
M5ANTINY	SANTIN
CELPA	CELIA
V1VUT	VIVOT
YWWARKLWEPIANM	MARIE PIA
IMAWE	IMANE
HATHYS	MATHIS
CMWUM7WRFNW	CLAIRE
Y1J0I5IEHPHLLJL	JOSEPH
YLYJLLTL0RJ	VICTOR
Y13RIEVCI	BRIEUC
ALRERQIU1LL2	ALBERQUILLA
REN1	REMI
MLASSJA	ASSIA
MAMRHNQWNDNM	ARMAND
YER1NA	MERINA
EME	EDME
BRI1ANTZEFFNCECIH	BRIANTZEFF-CECILLE
PTDUII	EDDY
MJLBUYUIKYLAYCYGIY7	BOUKLACHI
ED0UGRD	EDOUARD
WLWFWAHWHW	LENA
M1VIGKYLUF	VIGEUILLE
R7VET	ROUET
XL1BERT1	ALIBERT
JWVLIEN	JULIEN
YAYN	MAYOT
SMETIT	PETIT
WHWEAAJRHW	OSCAR
TYZPHNHEE	TIMOTHEE
W1JHKGH	SARAH
MWLYGWAIFV6F0LFVEVVLLJII	GAFFORELLI
ETHAJ	ETHAN
MMQ1QLT2PE	MORARILLE
MNQW	MANON
QUENTFN	QUENTIN
LMLTE0	TEO
LUC4	LUCY
WWLMTWI1CIT6UHAHHGIILIUTY	TESTU-HALLEY
Y6HUC0	HUGO
JMQYQ7AABERARD	BERARD
Y1MTE0	MATEO
WWW0LNMWNNW	NOLLAN
HLLN	MILA
AVELLIWD	AVELLINO
Y1TC1ICPPR	FERIEPPE
LLWPPLYHYVYVL0ITLVVVG7	MULOT
KWXEVRYYYYY	LEHEUR
VIGWEAU	VIGNEAU
MMNNUYYYYY	DANJOU
EVMAERT	EVERAERE
AMW3ENLAIEHH	AZELIE
STEVEN	STEVEN
YFLLHHAHYTIERAEYAJELMDZ	CHARTIER-ENSELMOZ
YLD0RIAN	DORIAN
JENFL	KENYAN
LAPUYRYW	LAURYN
HARM	HARDY
MWADEMLMENW	ADELE
P1RENAWI	RENAN
AMLCHAYBEAYUGPYYL0EY	CHABEAUDIE
HWEHREHLLJJLHJLLL	ERELL
LM1PAUL1W	PAULIN
M1JVSTINE	JUSTINE
WLLI	KOLLI
Y1HHHW	VICTORIEN
XMEGRNNEVIJLLFI7	KEJEMNE
LW1KEVFW	KEVIN
AUQE	AURE
YIN1ANULENLN0NN7NWI1M	ADEL
MMLTERFI	TERFI
2EPINR	MEPINE
HULL	PAOLI
PHPPMYK	ADAM
MHEL	MAEL
CLPMY2H	CLARA
MEHDI	MEHOI
M1LCU1S	LOUIS
LY1CAYNZZZ0	CANNIZZO
CAPKYTLLE	CAMILLE
AMWXYIYYLYY	RENOUX
YLVHLNAKTLN	VALENTIN
PM1YFPCISWKPVHJN1K4CVWY	RODRIGUES
WM1YDWUTVPFBYUCRLY4FJL	DUPEUBLE
FJBIEN	FABIEN
M1PSAYHMIHPNYYV	SANTOS
VMALLEYIVYYLPY	VALLE
LWMHLVUYNG	LOQUET
LM1EHSA	ELISA
HAM	HARA
1WAKIM	WAKIM
JPERDKAV	PERDREAU
MAHV	MAHU
MWIYZWEIEHHTLKRIK1JJL	ZEGARRA
PPLYHYYAPLYYWRGEYTPYJY	MALTREF
WXHNFZHYI1J	DOAN-PERRI
M1P1EARE	PIERRE
LY1P0L1I	POL
LINC0T	LINCOT
CANDI6E	CANDICE
PIECHEL	PIECHEL
MW1YWH0IUUM07FJI7VJYY	HOUMEAU
YLISMAYLAHWIM	ISMAEL
Y7HCEWT	VINCENT
HUUNIA	HOUNIA
P1SARAH	SARAH
GVA7NTRAH0	GAINTRAND
MIWNVALI	BONVAL
WESKLNE	NESRINE
WG13WEIAUUYGYZRYK8KDUN1	BEAUGRAND
WLWAUNRWETTENW	LAURETTE
AILLI1JZI	SCHEUER
JULIETTE	JULIETTE
WY5TWE	CHRISTINE
M1FL0RINE	FLORINE
YARG0T	MARGOT
LP1L1MAXL1HHEHNM1IW	MAXIME
M1PAVI11NE	PAULINE
BPNJMIW	BENJANIN
HWYMJTEH1JWSELH	MARIE ROSE
NARTUS	NARIUS
PJLEQ	LEA
ZW	ZOE
MAR7FN	MARTIN
HMMTLNEWWANM	MILENA
L0LSEL	LOISEL
LUYJYE	LUCIE
W1MAR60ANT0IWE	MARC-ANTOINE
WJWVIK1WEHNW	JULIEN
BAAHES	BARMES
QM1FEN	REN
IW1WAMBFIHG0NGQ1	DGAMBI NGONGO
BEPJGMW	BENJAMIN
WYKTT1	MORETTI
CYZ1AN	CYLIAN
SEYMH	SEYMEN
T0M	TOM
EHLLL	ELOI
M1ALU1W1LW1	AUBERT
CACV1F	CAGVIE
WC0LJHYYLYYPY	COLIN
AWWWHAIEHW	NOEMIE
JUBRULLE	DUBRULLE
CAANTAGREL	CANTAGREL
MTLEIC0LAW0	ESCOLANO
FPRDAW	FIRDAWS
UPGRAL11E	CORALIE
WYLBYJPVHUE2NL0JBLVL	BETHENOD
YAPSYEMGN	YASEMIN
LMEHPEREUYYYVY	LEMPEREUR
BUI	BUI
BY0RTH	BORTH
LEMTTEVIH	LEPOITTEVIN
YLE1WIHL	EWEN
MIEM1GN	LEMAIN
M5F0KEAVID	FOUCAULD
WWET	BOUTET
M1IJ0UYQVYEYUJVY	JOUBLE
PL1YHCHKHEHINW1W	LOANE
MRET	MORET
WLALZM	JALLADE
Y1LCNTL5IELBA5A	VILCOT KIELBAS A
MLARWDUN	ARNAUD
CPPA55AWRA	CASSANDRA
CKETE	CRETE
LMYYEYG0FYFYPYYLIPU	LE GOFF
NWWATTWE0HW	MATTEO
MW1YAVFLVK1VIUUJH	VER
HHNUU	MANUEL
MMWYAWNM	ABY
5MPAJYWGLYABDVWYYYVYP	SAINSARD
WUILLAUD	COUILLAUD
MW1YZPALVPAYVTAV0HVHEVNTA1IJ	ZAPATA-METAIS
THMHH0AMHA5GIH	THOMAS
HMYYCYYQYUAYTYVYLYVVY	JACQUAT
M1J0AH	JOAN
RUPICD	RUPIED
DLIANE	DIANE
PLVIHLEHT	VINCENT
BEXTRHWU	BERTAND
R7VIERE	RIVIERE
LIYXLZ	LYDA
LMW1FERPWVAYHYDYEPZYY1	FERNANDEZ
HMHHTTZYGVAVTJV	SCHMITZ
WM1M1WN10NA60A0L10LJ4SMYL	CONCOULER
TPH0MA5	THOMAS
YWAHL1A0U11UVVGNFJN	YAHIAOUI
MMWRCEJ	GEORGES
MY1YYUHYY7KYRUWY0I0LDJQ	UNDERWOOD
LM0ISYYYGYYG	LOISY
MM	BACQUEROT
GWBAH0UGYYYY	GBAHOU
BCNNJT	BONNAT
LHWY1YDYYEYLVA7UWNYEUVAI	DELAUNE
MW1MWM1QUHAU7DDYH	DURMAZ
N0VICI	NOVICE
1F11I001ICWFMX	COOPER
VPLVDW1YKHER	VLUDAG-YENER
CLARR	CLARA
UWIJ	LOUIS
EPHEW	EWEN
AXEL	AXEL
HWNALHJ	NINA
M1UENENTLIHG	CLEMENTING
IMPJYDYULUPUDYDH2WY	DUPUY
LP1DLEGFS10N1RS	DEGISORS
M6HU00	HUGO
MAI51IL	NASSIM
P15HELLY	SHELLY
MWHAXMLWXCNM	MAXIME
DWYUWYPHYVVJYT1JJY	DUMONT
LMAME	LAPEGUE
EY0PE5MDLJVEIM	LOPES DE OLIVEIRA
KTI3R0UH	MABROUK
WY1YMFRLV0YD0VHHJ2YI	FROMONT
HETRAL	METRAL
G1LET	GILET
TWGFFAM	TIFFANY
2DNAR4A	ZAMARYA
IMIERSTEIW	DIERSTEIN
LIMLLEHHY	LENNY
F1GDQ1M1LCLU	DAMILOLA
JJLLJJYE	GU LLAUNE
XHL	ALI
BR0CHET	BROCHET
FJWI5	FINIS
VICTDK	VICTOR
D0RJAN	DORIAN
HAN1HEE	HANAEE
CHABHA	CHABHA
B0URHE0LJ	BOURGEOIS
HMWNLM5W5ANM	ANISSA
DELB05	DELBOS
MYRCZYHSXY	BARCZYNSKI
LY1LUZENLAKL0	LUZENKO
WMLMWU101I5D6HW02C	THIERY
WWFAMKWHURNW	FATMANUR
YLMLATTHLIEU	MATTHIEU
JWLR02LAND	ROLLAND
IMP1YJNP1PHA5IIL1LQPLJLJNZP	MARCASSUB
HWNH	VICTOIRE
LM1ILPECYEPRJVFVLVQ	LECERF
QBWEH0JT	BENOIT
F1UVKI1Y	LOCK
TAKBUNVH	TAMBOUR
CMXMEY4VLIWF	LECONTE
MWLLENNWETTNM	CLEMENT
LPPUYD7VIWE	LUDIVINE
ATILA	ATILA
M1YAL7NE	YACINE
MW1YWCAIVVJLTF7KRYDZA	CAULIER
TWXIBAVD	THIBAUD
KHUEF00UL	KHALFAOUI
H0EMIE	NOEMIE
IM1YGAIVJLLYUAHWNLEWV	GAILLANNE
NI1L0LASHLJ	NICOLAS
MLMN1TE	CLEMENTE
FAN6L0FC	GANGLOFF
CHARLUTTE	CHARLOTTE
P0TI1ER	POTIER
MWLLFJL	MILESI
MLJUNYW	JERUME
MFM0UH0MASSE	MIMOUN-MASSE
HEPHIHE	JOSEPHINE
CDNRAUX	CONRAUX
WY1WHRIVLIADNVVYUN	HARIN
LF1BFCH0UAY	BECHOUA
MYTXZAS	MATHIAS
GWM1LWJNIRWMJ1	CHERRAJ
AUSSEL	AUSSEL
KPP5E10V	PIGEON
MANE	MARIE
M1NART	MINART
WMIURNEWNT1HHW	CORENTIN
NHMHMJYJWEHILH	MARINE
AWLWWJTYSL	DUBOIS
HII6A	MILA
IJI1L0BJRUNWJD7NN2WL0M	BRUNO
YAPQRFEN	ADRIEN
CELYA	CELYA
BL0K	BIOR
CL9PU6IPE	CAPUCINE
EHHA	EMMA
LAM1LMAVUHL0YUQVR4ATVY	MAUHOURAT
CWAUDWN	CAUDRON
GABIX	GABIV
STNHXC	STRANO
HAW	IVAN
M1RQGAHK	ROMANE
WEKVEH	QUEKVEN
M1CHEL	MICHEL
WLALBANEL	ALBANE
JAS5W	JASSIM
HYUN	RYAN
MLINE55	INESS
DLE60	DIEGO
AMFHDL	MENDI
NM1TE11XELRAY	TEIXEIRA
L0I1JU	TONA
6LNLBMT	GILBERT
DPEYHAI5	DEHAIS
P1ALISW	ALISON
DELAW6HE	DELAROCHE
Y1MPIHLHL1HHH	MORGAN
LMHFDNNF	LAGDAM
IMLBKLLUUDR0USSEL	BALLOUD ROUSSEL
CHARB0NWEL	CHARBONNEL
ELWJM1JLHLEHW	EMILIEN
M1H0G0	HUGO
ENKIS	ANAIS
MLBLMIL0MIIN	BENJAMIN
JMYPGY1YIYYNCYYHAVUISIPYEYN	INCHAUSPE
P1JE55Y	JESSY
IRH	IRAK
WLIE	JULIE
M6L0UISE	LOUISE
HPTIFTE	BAPTISTE
CWADDA	CABON
J1ULIE	JULIE
LHWE0AJHW	LEO
BDKLIC	BOULIC
KMLPELRRL10LII1SH1	PERROIS
AM1GLEMT	GLENAT
YCXL	YONI
MMART0HG	MARTINS
G1IZYYYC1KYYPY	ZOZIK
FSURWYEH01WER	FOURNIER-SOLER
WVYM	KOEVYM
WLA1TFC	PENLNGAULT
CHH1YH	CHAIMA
Y1CHELCHTLLHEIHNHWLH	CECILE
WIISILVAHUHK	DA SILVA NUNES
PASTYB	PASTOR
CFLL1A	CELIA
THAL9A	THALIA
WYYGY14GAVRLYVIAYJAY	GARCIA
SWUSAHLL	SUSAN
P11ERRE	PIERRE
MCIKEU	MATHEO
GM0DAKDYYPPYYG	GODARO
LWLEHZU	ENZO
WLIFF	JOLIFF
RLFAAT	RIFAAT
M5AVAWYVVAPVIP	SAVANI
MIBIZILITRM	NIBIZIGIRWA
WEWVAWW	EVA
MLM0UMAWNENW	LOUANE
ALB0YVAW	BOYUAN
IW1LWYTYYKEPYURYYY	TREURY
NMAWEL0YPYVWGN	REBELO
HAXI1ME	MAXIME
MIWDUATW5HW	LOUIS
YIHW0H	MANON
MP1YYM0YHYEGVAHYYPJQ	MOREAU
CYWLEHCW	CLEMENT
SHRRN	SARRUT
AWUHZIE	AURELIE
YHHLL51AJBHI11N1IA1HHIH	GABIN
WMW1CN0WLASAW	NICOLAS
MW1MMRCLYUEPR6WVYL	ROYER
DES12	DESIR
CASSAWDRA	CASSANDRA
Y1HUM	HUGO
MNKRLLLKK	NERCIER
NKCW0WYHUYT	DENIMOUT
HWISA	ELISA
HMP1YYRCYYU5LSJELYAVUUV	ROUSSEAU
GLAWS	GLADYS
M17PYYHWYLFLNCLHPWLYLI	PAWLICKI
5HTELWNHJ	STEVEN
MAR1JA	MARINA
MMLM1MU1NVD4UN7YT7V	CHORD
LYSYHNT	LE STRAT
MMS50VPPIL7JY	Rosso
FLEYRY	FLEURY
MLHGATHI	AGATHE
M1LWAANNE	LOU-ANNE
IF1DUTH0ITAVAHHELKE	DUTHOIT VANHELCKE
MYGWCW	JAMGOTCHIAN
5Y15CVDTH	SISOVATH
TM0URIER	TOURIER
J0UVE	JOUVE
P1CHARL0TTE	CHARLOTTE
IWMJMJJCWLH	FRANCOIS
WWIWEYYVYYVIV	COINTE
BANQNL0	BAMONIO
I1P1LF21EX	LOZIER
W1DUVYAYYLYYG	DUVAL
MARI0T	MARIOT
JLL0N11U1K1UKIIPAIHMLM	UC
YAJDA	MAJDA
M1CLEMEHTINE	CLEMENTINE
M1LEA	LEA
M18RICE	BRICE
LMEFEKV8E	LEFEBVRE
HYYHMELLIU	HYSENBELLIU
M1AHKFD	AHMED
Y1M10NHUIILUNF	MINGLIANG
MLADNANF	ADNANE
KULLER	MULLER
MMWAGHW	LENNY
ESTELW	ESTELLE
NYRIAN	MYRIAM
SHWA	SHANA
MLJULIE	JULIE
PHILLCT	PAILLOT
LBVL5	LOUIS
FMLIINPERWLYP	FLIN PERON
NML	NAWEL
BELARBT	BELARBI
LM6TQLAWL	TIAGO
THDMK	THOMAS
NM1VARYLPEAYULTAHAL0FE	VARIGAULT HALOPE
CTPRTAH	CIPRIAN
FIHH	FLOCH
GM1NUC0RPHPEYTPY	DUCORNET
VJHCEM	VINCENT
JMWHMEWHYMM	JEREMY
DUILHUAY	DUCLAUT
GUEHENNEUX	GUEHENNEUX
ZDE	ZOE
IMY1YLPALVBEVRVTV2Y	LABERT
PLBRPTYSTE	BAPTISTE
T0H	TOM
MEUR1E	MEURIE
WRENA	MORENA
M1AHT0KIN	ANTONIN
60EWHE8CUR	GOETGHEBEUR
NATEY	MATEI
BA8TLIEW	BASTIEN
B0RIA5	BORIAS
JULXWE	JOLYNE
XWWW	FOOLON
CHZZM0	CAZZATO
P1LKHYALYDYYI1IPYY	KHALDI
M5CHNH0UNFCKER	SCHOUMACKER
MM1YCMGIVEAJY10JTIJYH	CABAYOT
LY1ACKEYRP	ACKER
LWHLLJHY	WILLIAM
M0REHU	MOREAU
YLPM0VNTFAVNLEVRYPY	MONTANER
LGM10WUJIUNY04NU7PWJJ	OUADOURI
CI7Z	OYBE
P1JADE	JADE
MFMH1NEYPYG	FONTAINE
YLAK	MARC
LP10AM1EN	DAMIEN
CWMKNWEMAM	CLEMENT
M1HM	ELEA
H0RTEN5E	HORTENSE
IM1KRAYEM	KRAIEN
5AEZ	SAEZ
YTHEN	ESTHER
LMM1MYHD6QUYR00WLYKLPHWI	MARROUKI
LEPEU	LEPEU
CHLTAHAY	CHATANAY
DANLFN	DAMIEN
SWW0UKAWDNW	SOUAD
M1HSF	LISE
MMEQUNJVYYPY	LECUYER
LJMLALAUXY	ALAUX
YFRYAN	RYAN
MLA0RIFH	ADRIEN
WHJJLAHAAHW	SACHA
YSALZAM	SALZARD
TMWH0MXWA5NM	THOMAS
RX4AH	LAYAN
P1HWFEL	GABRIEL
FM1JWEH	JULIA
LEC0RRE	LE CORRE
WLPIHLENAN	THIENAN
TAB10E	FABIOE
LUCAY	LUCAS
MW1YDMELJVAVWWVIYNVYD	DEJARDIN
GMERBAULJYY	GERBAULT
M1ALEXFS	ALEXIS
Y1LSAKYDG1L0YLVUY	SAADI
HILS	NILS
MMLCWLIUGYLDT4YYH	GEST
MWLUKNHWSNM	LUKAS
CMHARQIEREYGY	CHARRIERE
WYWMM	ADEOCHOUN
MLBARYBYEUTEAGUGY	BARRETEAU
THIQAUT	THIGAUT
CM0U5IX	COUSIN
MMYAYUYFPPNSVJ0UWGN	BEAUFILS
ILM1LAVRE	LAURE
DE6FNFKZELLE	DELATARZELLE
CUHELJW	GUIZELIN
HRC1U0LLW1	GREGOIRE
Y6T4E0	THEO
WARLNTE	CHARLOTTE
NM1BAUPDYRIYYN	BAUDRIN
T0KNAK	TOKMAK
LMM1YT0YRVRELSIYVNY	TORRES
EY5TEVE	ESTEVE
SYDUANVF	SOUANEF
AYXRFHFH	ABRAHAM
M1SIMDN	SIMON
CMWIEMHWEWNM	CLEMENT
KHIZIAM	EMILIANA
ALAV01HE	ALAVOINE
MPLYBYAYRYRVEVTIEYAVUVI	BARRETEAU
E6NCTC	EUCACIE
MRTAM	MYRIAM
LPPAPLY	LALY
FMW1LEL0NG	LELONG
TH05AS	THOMAS
YL1C0ULS5EDJEH	COUSSEDIERE
MLDXFME	MAXIME
YL5GD1EL0LH1	GEDEON
ALEXIS	ALEXIS
7MINH1WUR	FATIMA-NUR
LESUR	LESUS
MYLYJWELVAUHIVIUHI	JEAN
WA	EVA
M6T0M	TOM
WKZVAMME6H0UF	MURZVN--IZEGHOUF
Y1VIHENTHHI	VINCENT
RMJZWLKRE5	RIZOULIERES
WWHAWE	ROMANE
GIALLIAAVNRIEJNNLNMLIW	LAURE
GUILL0T	GUILLOT
NMIXA	NINA
NWLWFWN	NOLWENN
MNA	TONA
AUAN	ADAM
Y1L1RLELMLEJHLL1HMIW	REMI
YLC0LIHE	COLINE
WULWJRE	BOULDOIRE
EWIHULL0UX	HULLOUX
HWWELNIWSSANM	MELISSA
WPCRAY	DUCRAY
FW1JEAYN1PLERRE	JEAN-PIERRE
M1LDUI1SL	LOUIS
FLI6AJNNTI01ZNNIELNHMAW	ANTOINE
PFCHAWTAL	CHANTAL
GPWARAHCE	GARANCE
MELAWLF	MELANIE
EL0D1E	ELODIE
HMYNYTVRYAWPMYJN	VENTURA
YPMY	SBAT
M1ISCIANE	ISCIANE
FELICIEN	FELICIEN
BM0HEVEWYYYIP	BOSDEVEZY
AM1PHI1VRHIWYVDA7CLV0RIRE0IA	MIRANDACORREIA
MAPNYIW	MATHIEU
B0UKHUIK	BOUKHDIMI
RUYBYEW	RUBEN
LWM1GAU1L1T1I1ELR	GAULTIER
AMPAYNDIYE	AMANDINE
AMWMKAWNM	ANIA
YAS5LNE	YASSINE
T1F2IAW	TIZIANO
NML4B0VYRGVEG0IYS	BOURGEOIS
ZAHNAT1	ZAHNATI
W1LLNL1A1J	NICOLAS
WYPGLYYBY0PUYVRE1IWLAYVY	BOUREL
B1ZEAU	BIZEAU
LPAHR	LANA
YLZ0ELTINELLHHH	ZOELINE
JAHRUUG	DAHROUG
LMMUNMLLQVLNEAW	LUDIVINE
MARWN	MARRON
HTMJR1J5H7HAHH	TRISTAN
HAHLE	MAKELE
MMDR6VEYPYYPLVY	MORGUE
GMENHAR0VDIJN4	GENNARO
P14PRIVCVEIYVUVP	PRICE
HLQU1IHW	LOU
GIBIIER	GIBIER
1EW3T	LEOST
MCLEMEM	CLEMENT
SKWHHW	HANNAN
I1G1D0WCN	DONON
MLVBQAH	DEBORAH
WALN	MORIN
E1NU	ELISA
FFHHC0K	FRANCOIS
8MEFHICHEIFAUJVPY	BEGRICHE
M1MTHEU	MATHIEU
LTHHYPAFYE	THIEPAINE
YIL1ES5	ILIESS
DDHDVAH	DONOVAN
MW1YWM1VHUFWWLJ	ROCHF
CDLAWCC0	COLACICCO
JR0GER	ROGER
A1LAH	ALAN
FWYEX	SEYMEN
MTFER	POTIER
MLHEL1NE	HELINE
DERRUAU	DERRUAU
ZWE	ZOE
MFHUCHEYPYILYGY	CHUCHE
P1HLLLLL0IZ	MILLIOZ
HPARYINE	HARINE
0MLSWER	SUTTER
S42AH	SARAH
IRPIYNA	IRINA
CHENT0UF	CHENTOUF
MWANWN7WHEMW	ANTOINE
W11UCIE	LUCIE
QUIHNCN	QUIGNON
WY1YTYCYVHUIIELWJJTEJLL	TCHUENTE
LEAHI0	ENZO
IMLUMGLYEISIYASG	IGLESIAS
YANHIS	YANNIS
APHTY0N1W	ANTONIN
LM1ELGA	ELSA
RCHIEUX	ROMIEUX
M1HUCIE	LUCIE
AV1AN	ALAN
KWM	PIERRE
NAWTLH	DANTIN
MCWLENNWEWT7YEAM	CLEMENTINE
DANA	DANA
YIA15IITMIDNQ1HLNWIIM	SIMON
P1LE0	LEO
Y1LAMBERT	LAMBERT
LPL6ABIN	GABIN
MLC0REHTJH	CORENTIN
EP4SG	EPYSA
NWALTH	NADIN
FWDVRH3ER	FOURNIER
MM1B1EIMLEARI	BEMER
TMRECHPP7	TRECA
LLY1ELIYCEY0WWYVE	ELICE-BOUVE
WEYRYNCK	NEYRINEK
REWFULT	RENAULT
PMASTREYYYP4Y	PASTRE
HMHEREMETYIWLYSKLYLY4V	CHEREMETINSKI
SART0U	SARTOU
RDULENQ	ROULANQ
HPYATHAH	NATHAN
RQCHETEAU	ROCHETEAU
3HUDJ	BAUDET
WMDEGM	BERDEGAY
WPWERNRWLHENM	PERRINE
WLE5EURRE	LESEURRE
M1PFHYFLPYYYYP	PHILY
QUENT7N	QUENTIN
LUCA5	LUCAS
P1HPMM	MARISA
CWLAEYS1P	CLAEYS
MTL0PNYPYYLV	LOPEZ
THCMAS	THOMAS
D0ND0N0B0G0SAV	DONDON-BOGOSAV
CDPWU	CORNU
MMMWMWWAAW	LAURENA
EU5TACHE	EUSTACHE
I1Z1L1NCALUIKNEJLZLIHEJNMIIW	LAURECINE
MQH0MAJ	THOMAS
P1FICHM	SACHA
KIP	KAIS
W1EYEL1WE	EHELINE
JMDUIRN0VJYPVYQY	JOURNO
Y1GUERY	GUERY
KWIJTHPH	KYLIAN
ITTT	TTI
I1Y1AVEHET	AVENET
L1Y2VHALUJGL0NL	VAUGON
EL0I	ELOI
F1AKIXLL	ALIX
KVALTICRI	GUALTIERI
MWWMWW1IGAWI	BENJAMIN
HJTIC	MATIO
QM1TES5IER	TESSIER
WMMTMHWUHNM	ARTHUR
WMLMW1J1NBH5JILDH06YDLL	LANOIS
NW1WUBAKRYY	DUBARRY
GMWHLLVYVIP	ALZI
LM1PGUIYLLLYWYGIU	GUILLOT
M1ALYC1A	ALYCIA
HATHILDE	MATHILDE
MWLKML	MIKAIL
CHL0C	CHLOE
Y1FAWHY	FANNY
HLSSEYT1LKY	MISSEYTICKY
ECE	LOE
LEFAANL	LEFRANC
IMLKLIEIN	KLEIN
MGRIMH	GRIMM
MEMH	MERWAN
WCHYWWA	MELINDA
ALIS0W	ALISON
BQNNET	BONNET
KERYA1WE	KERYANE
LECERF	LECLERF
WPARENZHE	COMPAREOTINE
Y1J1LZCZ1J	CHOUQUUI
M1LSCVHULYDLVEUURZY	SCHUYLER
A1P6RELLATY	GRELLAT
HM1RS1BLEFR0	RIBEIRO
HMERHAN5	HERMANS
SLWJ0PJNJ1EHLJ	SOPHIE
ILCHENTIKE	CLEMENTINE
NW1CH0QUELI	CHOQUEL
ENHA	EMMA
HELENE	HELENE
MW1MMC0I4USLLL1NVUJJH	COUSIN
FWAUVAMYYYWJLI	FAUVART
GAUCHET	GAUCHET
CHAB0F	CHABOH
YLGUFLPLL0N	GUILLON
FM6AHYCVA	ALICIA
B7YNELAEK	BOMMELAER
FLAUCARD	BLANCARD
TCDDY	TEDDY
C1LEMM	CLEMENT
IM1QEHAYCYYH0VYRY	BENACHOUR
RDUSSET	ROUSSET
5MWERWAALMH0UV0U76NTG	BERRAHOU
JADE	JADW
HDURARD	MOURARD
LW6H5DLHL	LISON
QMWHA3MIVWYNVN	BENHAIN
LHALADI	CHALABI
L31MLHW0WLH	MANON
DEB0MY	DEBOMY
M1SHLWANE	SEYLOUANE
MLWWKIWENM	LUCIE
W1PIENRE	PIERRE
Y6FABL0	FABIO
M1LLLL	LILI
WJWULNEWKNW	JULEN
MLEGRHVEREYNYQYF	LEGRAVEREND
JMAWB	JACOB
PEL0S0	PELOSO
IF1BT0N	BRON
NATHILDA	MATHILDA
W1EMMA	EMMA
BMPEWYYIPYH0VMUG0WYY	BENSIMHON
LAMI61AIE	CAMILLE
LAURA	LAURA
WWCR0W	DUCROCQ
YWNV7N	BONVIN
LMYLLPNL6VNVHIYIAQHH	LACANIER
MLW7HMAWNW	LINA
H0RTENSE	HORTENSE
YYPLYGYYRFYNLY1EYRVYPJ	GRENIER
PI1SITHEILHHIHHQIJLK	STELLA
LULAF	LUCAS
PELSN	ELSA
MARIE	MARIE
PLRAS	PIRAS
MWLAVMRWANM	LAURA
F1XAVIER	XAVIER
LLWHDVH0HAMHHHJ	LOU-ANN
SUREL	JUREL
PAUL	PAUL
DTHHILLYDES5H1LH	DEMALLYDESSAINT
IM1SPGLIVEPSTYREI	SILVESTRI
MWRTIYYYVYVVA	MARTZ
HEME	HERVE
M0RCAWK	MORGANE
MPYAXIME	MAXIME
WHAIW	ROMAIN
JWLKYVYHC	RIVIERE
PLWQYHJ01L1LHSJH	EMMA-LISA
PERH	PEREZ
WHWQLNCJQNHH	MALCOM
YWP	MARVANN
BEAUFYW	BEAUFILS
CHR1JT0PHE	CHRISTOPHE
PDEHDAYE	DENDANE
WW1MNWALVUCBI1ZINYIAQUY	NAVAILLIER
MY1YTPALRVRTGTTNJVJIJ	TARRIT
MM6MGWR6AVWYDJMVVT2JD	GRANDONT
FIGWEJRED0	FIGUEIREDO
G0DJ1INFER	BODINIER
QVEHTIN	QUENTIN
MLRAPHAEL	RAPHAEL
I	LAURA
LTWHH0JMAL5HHHJ	THOMAS
MMMMMIWLLENW	CAMILLE
W1DAVLD	DAVID
JASYINE	JASMINE
AAELLE	MAELLE
PIWMAYLW	BENJAMIN
HAHINALAVAL	MARTIN-LAVAL
LEPEYL0U	LEELOU
FW1GWFFRFY	CEOFFREY
INES	INES
M1CHL0E	CHLOE
HY1YPCCLRVRJED1WAJPY	CORREIA
MMPAJY0PUPLPVVWWYU	MAJOUL
HAXHIUN	HAXHIU
MYLAVW	DELAUNG
HMY1YVYYEYJV7PHLVIVVAY	VESIN
M1AUGV5T1W	AUGUSTIN
MW1YDMU1PVRVEJLJJPJ	DUPRE
WLYW	NOCANN
ALES5AWDRIWI	ALESSANDRINI
Y1DELPAYHYAYYLEP5Y	DELAHAIES
HAIFI	NAILI
M1D8BL0	PABLO
W1LECII	LOUIS
TH0MAJ	THOMAS
MW1YZM0LUVAT7VIVVYY1V	ZOUAI
SFQMJLNIWD	SRAMINDAS
WLYNCF	COLINE
Y1RIAHII	RIAHI
WKAN2H	MARTIN
ZM1CA5BAY	CASBAS
JENMCWLAK	SS
HYEZYANE	MEZIANE
Y1JADE	JADE
MEYRINE	MEYRINE
LM1MAEVA	MAEVA
MMTYSWC1HVEVL7LNEWY2VY	SCHELLER
MTALW	MIALOT
Z0PANI	ZOPANI
WLANZH	ADAM
DS0RF	DJORF
MMLJAHYKYTGGEYG	JARRIGE
MWLMHALIDE7TTJZYYYP	ACETO
FLGRATTARD	GRATTARD
L1F1TAKHY	TANGY
PLEGRC	LE GAC
QMLJVJERYYYLY	OLIVIER
WUDC	CALDO
Y15LHDN	SIMON
LM1L0U	LOU
NYZILLILN1	DELIENNE
EL13A	ELISA
DLAUE	DCANE
THE0	THEO
MABWU	ABDOU
KEUY	KELLY
YJLEH	LEA
MIHE	AMINE
WPELRAET	WALRAET
HAMVTH	HARDUIN
FERRAND	FERRAND
MMLYKWEILVHELW0LWVFY1YDAR7	MEVEL-LF-DARZ
CWHENILYYYYY	CHENAL
LAHFLLE	CAMILLE
MP6YMYYFPIYVLV1EPYRZVLY	MARLIERE
MNLATPAYMRJGILIKH7NMIPW	TAYRICK
PMMA0MLWANM	PAOLA
KNHNE	JEANNE
THRC0W	HARCON
NCTQLNIJ	NATHAN
MMAN6JI0MRYYPYUYYULY	MANGIOME
TMMHISTWANMW	TRISTAN
TWAMT	TAMET
EL1E	ELIE
BYENAHADQVI	BENAMADOU
YLBASTLAW	BASTIAN
YPP0PHA	LOLA
P1VIXA1	VIKA
VW11LTJP	LILTUR
JANI5	JANIS
Y1HERVYE	HERVE
MT6IRACCAFY	GIRACCA
MRBERM	BARBERA
JPIAYMANTJS	DIAMANTIS
NWWLWHWLA5HW	NICOLAS
MQN	MORIN
AQCIGAUX	ANCIAUX
ELLSA	ELISA
MARIE	MARIE
NW1LAFAJRGGUE	LAFARGUE
LMYJDAJHHJHLJ	NOA
CHARLLH1E	CHARLINE
BWWAPATWFSTEHW	BAPTISTE
H0HWEAU	MONNEAU
LYSAWNRE	LYSANDRE
YPLYBYYLYAYNYCHHYV0GN	BLANCHETON
MHENHIIGUEVSYPIWWY	HENRIQUES
Y1ZKYC0YMYPTEYYLL	LECOMPTE
F1FAYQUXP	FAYOUX
YATH1GS	MATHIS
DJEMRT0LI	DE BORTOLI
0WWCWNWNENW	OCEANE
KYAME	MARIE
WMTEVYWVYY	BOUTTE
DEB01SAXGER	DE BOISANGER
HILVV0	MICOUD
MARCHAL	MARCHAL
6MRLY	CARLA
KHKZZ	RAKEZ
YIHIER	MINIER
MLANNAELLE	ANNAELLE
PLHHLYR	MAEVA
MWWADHLJIEHW	MADLIE
EWWYNAWBINHW	ESTEBAN
SALMDH	SALMON
LAVREY	LAUREN
CA551IE	CASSIE
M1ADANGY	ADAM
PEHPET	PERRET
PYL0YHGVVU0EYRVYPY	OLIVER
DW18AL8SXAWTHAN	BALASKANTHAN
SERHA	SERENA
Y6EN1ZDLHHHN	ENZO
FWWRNKNWYNW	FANNY
HWS	THOMAS
MWWGYKWIWVVPWYN	VOGRIG
AEWR	AENOR
WLPSAVHTY0PYUTYLLG	SAHTOOT
M1HIHVILNJ	HIVIN
L0U	LOU
2H	ZOE
IM1PWLLXYNVYVL4	DOOX
LEQMTHE	LEONTINE
Y1J0SEPHINE	JOSEPHINE
MAWY1C5	MANHES
MES	INES
LMW0UAAWANNNW	LOU-ANN
LEA	LEA
CWHAICWM0WSEAU	CHAIGNOO ROUSSEAU
L0WGEPEE	LONGEPEE
B0VT0VB	BOUTOU B
Y1LLIYFAIRYYPP	LIFAR
MA0REN0	MORETTO
LHRDLIHE	CAROLINE
W1CHJLE01PHHELEIIJLW	CLEOPHEE
LTLIAH	LILIAN
G1PZEJV3GNESYYL	DESVIGNES
Y1HERYRYYYYYIY	HERRY
MEWSTKEWBAWNW	ESTEBAN
CMWLENHWMGEMW	CLEMENCE
QU1LAY	QUILAN
LEFEVRE	LEFEVRE
WWIA0UKIWSENM	LOUISE
PMHLKYYLYYYGY	PAULES
LMAJXEJLJJ1LH	AXEL
DANIAU	DANIAU
LAWYYLYDYYVRAJWJDLJIYJ	DURAND
MHALNLFUFG	HAINIGUE
XUREL	MOREL
TRANCHRHT	TRANCHANT
PHELJPP0T	PHELIPPOT
LLMHWJHHLH	LOU
M1LEDHARD	LEONARD
FAIVREDJARLIEC	FAIVRE D' ARCIER
WR	DUR
MWBAPNTG1STEHW	BAPTISTE
M1CHLYYL3PREYYY	CALIBRE
UURTHFE	HORTENSE
WHWELNIWNWNW	MELINDA
MPL4B0VUWYVFERLUPY	BOUCHER
YTDRYIVLLAYUPDYI	DRILLAUD
J0HAN	JOHAN
ML4DUVTEWYLYYYVV	BUTEL
R0GKRLAU0IIEC	ROGER LAUDRIEC
Y1ML1AXLHEH	MAXINE
HMPN0ATGNAN	SAINT-AIGNAN
BAPTFITE	BAPTISTE
WLV1CT0RIWEF	VICTORINE
WWWMKWIHENM	ANTOINE
MJLEHA	LENA
HMWRWVALGYYYYPYG	FOURNIVAL
WRUCP1XA	RUCOIN
M5MHAW	SOHANE
DUBWS	DUBOIS
WMLVE5TK	SILVESTRI
DUCDUT	DUCOUT
PHCLN	PAOIA
PHZLIPP0TE	PHILIPPOTE
LYLMTPEYAYUYP	WATEAU
LP1YIATLHIS	MATHIS
FFHMLCHGPKYPYEMYYIEF	CHARPENTIER
GIFHUDEAU	GIRAUDEAU
WYAN	KASAN
BWXANEH1ERYPIYY	MENIER
WEYMIW	QUENTIN
NMGHYEWGPLYYYGY	NGUYEN
WMMHXMFWHENM	MAXIME
YLNAREE	MARIE
VMAS1LJEV1C	VASILJENVIC
ZACHARTC	ZACHARIC
CLARK	CLARA
MM1MW1IL0N3PI507G3NI	LARGO
CEPLIR	CELIA
E5TIVAL	ESTIVAL
AM1MARLYIYKGNFYYP	MARLIEN
YYENHESL	PERREAU
Y1BRUYGAYNYTGYYY	BRUYANT
5CPHIA	SOPHIA
MW5YNPAL1VH0UDFUMV0URTHF	DAIGUEMORTE
LW1HARGQNZ	MARGANE
ELCHAKH	RICHARD
CASSANDRA	CASSANDRA
LW	LEO
M1JSARC	ISARC
E0MAM	ROMANZ
F0NEL	RONEL
FLHHFYDLY	KHEO
YMPYS	NAEPIS
HHSS1H	NASSIH
5UMEYYE	SUMEYYE
R0BERT	ROBERT
MWWRMAGYAHW	SORAYA
IW1PEUZY1GATY	PEUZIAT
QDET	BADET
WIAW	DAVIAUD
MRW0MMAW1NAW	ROMAIN
ARNEH	ARMEN
MMTMWLI1HWQ23QN2IY2I1	LEMAIRE
NPATVHRN	NATHAN
LEELM	LEELOO
RAYH0ND	RAYMOND
0RT0LA	ORTOLA
WMWMNAWNW	EMMA
AWRZEL	ARZEL
MW1YAMNLHATHFDUVLJLJ	ANAIS
NRHH	SARAH
MUW0Y	URVOY
HYPY14NAGYIEPPYY	MAGE
IMLQ0RYYAWPTYG	MORANT
P11WE0N	PINCON
LM5ALILIH	ALICIA
HLIAN	KILIAN
MLUIZHE9MIQ	GEREMY
EWWUGMEWN1ENW	EUGENIE
M1SHAR0N	SHARON
MYMHXMLWUENM	MAXIME
MNN	IVAN
51H0H	SIMON
NMDEKC1II1AY	NDEKC
MLWJANJJMEJLH	MAXIME
QM1T115G5YYCTYL	TISSOT
LYET0NDWR	LETONDEUR
M1NARVLH	MARVIN
P0UWER0UX	POUDEROUX
P1RABIA	RABIA
91ELLSQ	ELISA
Y1TAGRYDPVYEYLF	TARDIVEL
PRDST	PROST
LHMUJAHSJL1J	LUCAS
NGUYEN	NGUYEN
MGWYIIEA	MERLIER
MFWABNIWENNW	FABIEN
YTR0LLANDI	ROLLAND
PHVLIHE	PAULINE
IM6INWYYQYVYLIT	FABRE
7WUHAR0LIYYHVGVY	FUMAROLI
MMMLZWLGWI	RANOUIL
MTLEA	LEA
QJUE1WIGIHHW	QUENTIN
HNRW4U15	MARIUS
53LYARAM0S	SILVARAMOS
Y1HEGUEW	LEGUEN
YLIRHLAHNDEL	IRLANDE
HG0	THEO
MLIJER	BOUVIER
SPPAYNUEI	SAMUEL
L0ISEAU	LOISEAU
HHWYGYYYYY	MAGRI
JBRAH1N	IBRAHIM
M1YIATH	MATTEO
FWKIMAUYYY	FAZILLEAU
HWMEJXHIJ5LH	ALEXIS
MW6YWDL1VPVLLILYYLLIGIAJBUVHFT	DUPOUY LABOURET
L0QUEN	LOQUEN
THEVENIW	THEVENIN
5MAUERYYGGPYYY	SAUER
W5HM	TOM
LMMYRMLGELLEHW	LYRIELLE
IWLBEKYRIAIYYVY	BEKRI
MMDLSMYYYYYYY	DANCOISNE
HUYNHAVAN	HUYNH-VAN
AWH1LEYPYLYVY	AMICE
MMWAYAHWLI7HW	MATHIS
LAN3AYS	LANDAIS
FCRR0NI	FERRONI
AUBVRT1H	AUBURTIN
KILL7W	KILLIAN
STEPHANC	STEPHANE
MLELE0W0GE	ELEONORE
LELLEGRIN	PELLEGRIN
MW1YFWAIHYRLN7WF1WYAHF	FAURIEL
TY0P	TOP
KANAW	TERNANT
HWLYWM1YIGLPLYG5CVYGA5	DOVILLIERS
HMAVHRLN	MAURIN
SHAMLESLIE	SHAMA LESLIE
HHVLE	FLAVIE
DUSQAYM	DUGRAVOT
JUUIGHYWURHLEH	JUVIGNY FOURNIER
M1ANDY	ANDY
CEWEW	CENEDA
HGYAHNA	ATAMNA
7ICARIFILL0	PICARIELLO
M1MAUD	MAUD
M1JAQRAND	JARRAND
LP1USCHR	OSCAR
HUCU	HUGO
M1YHEFYBYULMGELLF	HERBOMEL
FABIEW	FABIEN
YMWILYYYYPY	DETAIL
L0PUYISI	LOUISE
Y1SCPYRAH5I	SOPRANSI
YWN	YOAN
MLFELIX	FELIX
WWE	OCEANE
ELI0N	ELIOTT
LG1PYAYLY0T	PIALOT
WGRAHU2EYPEWTY	GRANDCLEMENT
F0US5ET	FOUSSET
WUCHE	QUEUCHE
M1WAUMRYWKNW	LAURYNE
M6FNAE6LE	ANAELLE
S1WJARJAAHHHH	SARAH
WFER	OGNIER
HY1YHPNLNV0TNYYY4Y7	HONON
MYLCYDGLY0VMAABYYNJV	COLOMBY
CALUT	CALUT
Z0LIS	LOVIS
LE1IWI1H6ERARTVELL1	LEININGER - PINELLI
M1AHDRE	AMBRE
TWI0TVYPVYGY	FIOT
TMIMUSTK1YYYYY	CAUSTROIS
LPI5YHNTE	LISELOTTE
MMWEALAHJENW	ENELINE
P1L7ITAH	LILIAN
PERR0USSEJ	PERROUSSET
W1DALYVHJ0TYVIPY	PACHOT
FI5CHER	FISCHER
ELIA	ELIA
LLLDU	LILOU
MMATY0NNET	MATHONNET
DUP0RGE	DUPORGE
BEX	BEX
W65HU5TMK	FAUSTINE
1FTHUR	ARTHUR
LLZ1I1CL1HAIXLLL10SHNMLW	CHARLES
IM1MAR1HYYYVP	MARIN
NLA7TE0	MATTEO
CAPUVIW	CAPDEVILA
KHSELIA	KASELIA
GREF0JRE	GREGOIRE
HPNPHAE	HANAE
KGLRTIHE	MARTINE
M1IHANR	IMANE
MHKAY	MANEM
LDUHA	LOUNA
WY1YPD0LUS7IYYYYV	DOS
HA0U0ANNW	LO-ANNE
50WLZ1JAT0N	SOUPI-JAMON
WHAHCLILMYYPPR	HAMELIM
LL0NN	LLONA
Y1EL0I	ELOI
WWWUKIWSNW	LOUIS
VAWKERCKW0RM	VANKERCKVOORDE
EWM	ENOLA
PRUCHUN	PRUCHON
PALMRS	PALMAS
MW1MMRF10ING3LNNGYGB	REBOLO
BRHHGH	BRAHIM
AWMHWAWIHHW	ANTOINE
MZCHARD0IMEL0M	MICHARDMELON
BAU0RY	BAUDRY
DEG0T	DEGOT
W1N1L0LAI	NICOLAS
A1NGELE	ANGELE
MLL35A	LISA
LNUV1ME	PAULINE
APPLYEXRHDRA	ALEXANDRA
LM1INES	INES
WAHGELE	ANGELE
MLB0NNETH	BONNET
RWPF0R	ROHRER
WPPLYLYYEV5LYVIFLY6Y0PHUK	LESCIECCOUR
CWLHAMJIHLHLEHHH	CAMILLE
LMLKVAM	RVAM
Y1YSEE	YSEE
LY1C1AFAY0L	CARAY OL
W1CAWIHHEAHWIWL	CANDICE
AAPTY0IH	ANTOINE
AM1HALGAPHD	HALGAND
S1NAT	SIRAT
WEALMIIDA	DE ALMEIDA
HKKN15	KERNIS
UEAWE	OCEANE
NTVMBAMKENDI	NTUMBAMUKENDI
JVLI1E	JULIE
C0RAZ0W	CORAZON
M1HSMIAE	JASMINE
MWJMMPHLVDTWWN	PETIT
HAIUFU	MATUFO
UMHIHE	HATHILDE
HF0AULC	MOALLIC
CARPENTLER	CARPENTIER
M1KELLY	KELLY
M1C0NSTANLE	CONSTANCE
FAPVNINL1	FAUSTIN
FHABLL1MHW	FABIEN
MWARTLH	MARTIN
WLAIAM	LADAM
0WFT1IWJEKYYP	OFTINGER
P1MARIE	MARIE
M2XIME	MAXIME
HLHAHD	GRIHARD
RCHAZW1	ROMAIN
JWL11S	INES
AWSELA	ANGELA
MKKHM0	BARRETO
5GIA	SOFIA
M1PLDAHE	ALBANE
CYAYDICE	CANDICE
MMMEFVWTWHY	DRAIEF
8ERYL	BERYL
Y1MAL0	MALO
AALHUR	ARTHUR
TH0YR3	THOMAS
JAHJAH0	SANSANO
Y6VICT0R	VICTOR
Y10CEANE	OCEANE
MATH1EU	MATHIEU
LM1SAMANTNN	SAMANTHA
ZAKARYA	ZAKARYA
WLIH	COLIN
BLJULFIETTE	JULIETTE
Y1HAILEXWJDM	ALEXANDRA
RWWE	ROSE
GAWIER	GAUTIER
SYLA	SILA
JMY1RPELPYUP50SYEJAVUJY	REPUSSEAU
P1LPSA	LISA
QUX0N	QUITON
AM1TRTPTY5CHYYY	TRITSCH
MP1YYLELKYFAYCYUJDVI	LE FAOU
31AYAEILLL	AMAEL
CCLLINU	COLINE
MATTHKEU	MATTHIEU
GY0SSE	GOSSE
SANUEL	SAMUEL
MLLHEYPVP1YNYYY	HEPP
SIAL0HE	SALOME
KM0MAIW	ROMAIN
YL1LKH3R	LEHIR
CLEMEME	CLEMENCE
CDURT	COURT
W1PRULL1NEL	PAULINE
M1AAF0N	AARON
MMA	GASSAHA
LHAUIMET0WKWICR	CHAUMET-VENIER
M1YAKIIII	MANELIE
BRLZAY	BRIZAY
MW1YCWULVVUMFUMIUAU	OUURARA
JCH0VYRYRNS	SCHOUTETENS
LEWA	LEWA
AMYWWYICWWY	ANNIC
L0TYE	LOIS
MPWAN0H	MANON
AGATAF	AGATAE
HCHML	BECHAMI
AHAMIWE	AMANDINE
ALWJL1JHJHI1HH	ALICE
NUABHCERA	NDABAGERA
ALVE5	ALVES
LMY1YCYYH0YIY1ZIT	CHOIZIT
E1MILIE	EMILIE
MP1YYHYYFYSAVYFIILN	SAFSAG
LM1NZPH1ITGLL	NEPHTALI
IAGKLL	ANGELE
FPAYR1IYH	FARINA
FM1TK0UAH	TITOUAN
YF1YTYUVRPUJLNYVAT4VIL	TURPIAT
M1AUREL1FN	AURELIEN
HARDY	HARDY
CYPRIEN	CYPRIEN
M1C1VEMFNT	CLEMENT
0WWKAKNWNW	OKAN
D051SAM0S	DOS-SANTOS
M6SASTIEW	BASTIEN
LM6FLAYZE	FLAVIE
WY50	HUGO
PWWCHEL	DEMICHEL
CM1AJ1ISL	AIS
YLEMYA	EMMA
2BMLKAHF1	ABDELKAMEL
CM1MERYYYYELLYLPVENYUU	MERVEILLEAN
SALPS	SALIS
GYY1YCYRQYVPEYTPYYYY	CAQUET
BYIZART1LIH0W	BIZART-LIMON
P1JADE	JADE
0WU	OU
SAWEL	SAMUEL
MLALEXAHDRA	ALEXADRA
KELY5	KELYS
PLLM0N	PICHON
BJWARVCQ	BARUCQ
LWWF5KLWENW	LISIE
JTEUEW	STEVEN
MAH5ANYGPYVY	AHSAN
MARCEAU	MARCEAU
MLGAELLE	GAELLE
MY1YPB1I1YLY0NPJLY0LTYZ	BILLON LOTZ
1AKMAK	CARMAK
M1HAYLFS	HAYLIS
MMI	DEBO
VICTDRIA	VICTORIA
NW	TONY
LCMZ	LOPEZ
JAHRAM	JAMRANI
Y1YHD1HN1NLLLAHALK	YOANN
FMWLAMVWIENW	FLAVIE
EWLIAW	ELIANE
LAHEUITE	LAHEURTE
RY0LKH	ROLKA
WWLMNM1L0DL1I40D0HAT	NOT SURE
MATHIS	MATHIS
MWLTUXYVLYY4YY	DELTON
FM1HCMHW	ROMAN
M1BAPTISTE	BAPTISTE
KRAWCZTK	KRAWCZYK
GALLM5	GALLAIS
APLHAKBRE	ALEXANDRE
3CURMSE	BOURRASSE
PLADELLWE	ADELINE
C0LINE	COLINE
M1ALIJE	ALIZEE
THR1LE	MARIE
A1EVFWE	EUGENE
M1JUL1M	JULIEN
MYYY1LBERTYIYDHLEPIIPP	BERTONE
DWELPECHYYYYYVFG	DELPECH
ABKAM	ABKAM
WRC	MARC
G5THDMA5	THOMAS
P1MF6VLN	MELVIN
HYM	JAUNAY
MMWHKWMENM	MAXIME
MARLE	MARIE
KCRCAWE	MORGANE
WWIMTWD1N0I8L6I100TT6H	TADAULT
LJW1C0UWUE1Y	COUQUE
JEAH	JEAN
CWL9MLY	COULIBALY
CARLA	CARLA
YMWH10MBHWULTNW	THIBAULT
FFWTH	FANTA
CLARA	CLARA
W1LZA	MILZA
KII111SAIM1U1E1LL1NW1LW	SAMUEL
MM1PEYYYYYYYY	LEMAIRE
KUCHCWBUCH	KUCHENBUCH
S0UFLHE	SOUILHE
MY1YIPALFYRPQ7UIYQEY	CAVROU
JLMNFCD0	JUANICO
MUNET	BRUNET
EWWNNSGEHW	ELOISE
K0N5	KONG
JNAT1ALNHW	NATAN
SALDHE	SALOME
PLPU11ILE	LUCILE
DUM0HCEXUX	DUMONCEAUX
LWWISNAANW	LISA
YLTHIE0	THEO
FPERMIAV	PERDRIAN
AYLEX7NIKE	ALEXANDRE
M1WLUATH	SYLUAIN
MSJM0NYGYG	SIMON
M1D6MYAYRYLYIFY	DEMARLY
MWLAHMLWLLEAM	CAMILLE
QHELLA	ORNELLA
LP1ARTHUR	ARTHUR
AFIT1HAWU	AIT-HADDOU
IWW0LKAWHNW	NOLAN
Y1L1NLAIQIMYNSJLHMIW	NAELYS
YPEDBMA	PEDROSA
MLGIZCM	GIZEM
YPLYDYEYJYEPAVNYYYYI	DEJEAN
JULIETTE	JULIETTE
MLKYLLLAN	KYLLIAN
MMH4NAWNM	EMMA
L0U	LOU
HATH4H	NATHAN
WWEW	NEAU
HJ0IQ1VJH	HOLQUIN
TYRAYCX	TRACY
WWLDMHWAW	LOUIS
JUDE	JUDE
P1JILC1AN	JILLIAN
MKERAMPRKN	KERAMPRAN
WWWLAEWJNW	JULES
AHP6YELINE	ANGELINE
LAP0RTE	LAPORTE
MLVEWU5S9A	VENUSSIA
H0U5QUCJ	MOUSQUES
MWMARMTW3NNW	MARTIN
T0M	TOM
IWTLTALQYPYY	JACQ
MLHUG0	HUGO
EERM	ELRAM
WEXHAYVELLE	EMMANUELLE
1LMM1YCWALWRRAYT22VYN	CARRAT
CTHFDNHD	CHARPHED
HU	HU
L0UISE	LOUISE
KHCHPE	NOEMIE
3UWWE	DUCHENE
GABYRYELLE	GABRIELLE
Y1MARCIA1	GARCIA
LLG6CL01TIHENET	COTHENET
IM1CAMGGUIYLHEMY	CAMGILHEM
HKTIC	ARTIC
AHEII1L	ALIX
Y1V1IRG1ILE	VIRGILE
HZLPEWE	HELENE
LWAWPH1E	LOU-SOPHIE
YCW0LLHE	COLINE
WT0K	VICTOR
HM0RAJSVGPYYYAP	MORAIS
YYPY5YRYY0YW7DEYAYUYPVY	RONDEAU
P1ALBRN	ALBAN
C0WAN	COWAN
MENET	MENET
RLL0INAL0RDIER	ALLOIN CORDIER
H0FAF	HULDA
DEL1EEE	DELIEGE
Y10CLER1NE1	OCEANE
0YSDRI0	OSORIO
JW1LEQUE2E	LE QUERE
YJAHEELE	ANGELE
MLHEJLLYN	HEI-LYN
HIZUL	DILAL
FHM	FLEUR
CW1JASET	CUISSET
LPYDYLIE	LYDIE
MSTIEN	BASTIEN
MHWLJLHEHHIH	JUCIE
KIFM0UHE	KISMOUNE
LAPURN	LAURA
LM1SWANE	SWANE
BMRULDHVTLGSVGF	BRULON
NCIR	NOIR
LAN0ERT	LAMBERT
BMPERYHYHPYTVJHJNJ	BERNAT
M1MARGAUX	MARGAUX
ALBAN	ALBAN
AMAWHWE	AMANDINE
WCAH	NOAH
P1BEIN3NALMGN	BENJAMIN
WMMISYYVYLYYY	DUBOIS
MMMYMWNM	EMY
GUEDDQURA	GUEDDOURA
WLMJRJIE1HLUJCIHE	MARIE - LUCIE
JM1JAL1UCHET	DAUCHOT
MGWJ	MANON
LMM1AHD	LACAND
TLRWH	TIANA
JWBAL	IRAZABAL
HAWHRALJMHH	MARINE
ABAFF0UR	ABAFFOUR
HII0N	NION
M1EL0T5E	ELOISE
YRP0PNAH	RONAN
Y1LMALIBYIL	MABY
G31ANAT5	ANAIS
6HMU1JLH1HAUMJEHH	GUILLAUNE
HATHW	MATHEO
WWS	NICOLAS
FABL0	FABIO
M1511D1LZLNL11HWLK	LUCAS
MREMYYYGYYYYY	REMY
IIUNLVEHC	FONTUGNE
M5ALIH	ALINE
RCB7ER	ROBIER
2H0EUWG	CHOEUNG
AS0NYF	ARTHUR
SPEDHW0	SEDANO
SAMI	SAMI
FIEKRE	PIERRE
CHL0E	CHLOE
NAXC4KFE	MAXENLE
Y1GERFAUDLIVALENTKN	GERFAUD-VALENTIN
WMWENWNW	EVE
6MMREWAUIMDYJV0IUU	GREAUD
AHBRE	AHBRE
LELEHE	CELENE
MATEH	MATEO
CANPEPTGER	CARPENTIER
M1RDNAIN	ROMAIN
BEAU5S1EU	BEAUSSIEU
HAHELEJADE	HANELEJADE
M1DAN	DAN
ILU1	ELOI
PAUL	PAUL
WMEBF2YY	WEBER
JW0Y	JOS
DWEN0YEHHEYFFYYF	DENOYELLE
M1JEAWMBAPTISTE	JEAN-BAPTISTE
MHWVILLEYPYLYIP	NEUVILLE
MLMATHI5	MATHIS
Y1L0UYTY5YYGI	LOUIS
NEHAUA	NEHAOUA
A0ULIEA	AOULIER
LEHESNWEH	LEMESNAGER
LY1KATLTLHHIHFIV1HJHH	MATTHIEU
SWEM5YEN	SEBASTIEN
VERRLER	VERRIER
L0U	LOU
YAKKLCK	YANNICK
CWWARJLWAW	CARLA
FHHKJWL	AMBRINE
M1LLLIMW	LILIAN
AMAPAAEL	RAPHAEL
LYL1A0UPVIERGY	BOUVIER
KIVL1INN	KILIAN
PWPA	LYA
BEWHAR	BENAMAR
YYYYLYFHEVMILIAQVV1VV	CHEMLA
CHL0E	CHLOE
HWMAHA0WWNW	MANON
AMMELRYYYYPYI	AMEUR
MLPSETYTEGYYAGY0	SETTE
WMVVILYN	REDANT
YJGLI10IHII	GIOMI
WWLMXW1HID1JWGF	EVICUAN
Y1CHAM0ULEAU	CHAMOULEAU
JPYDLE5	JULES
M1NNIN	ODIN
WWLWKIWSNM	LOUIS
RYEMI	REMI
IM1BLVEWQWLTYP	BIENFAIT
JUD1ITN	JUDITH
YLR0BJN	ROBIN
RKVZLLER	REVILLER
F0NTENEAU	FONTENEAU
LMUWEYUULLN4V	LECONTE
YL50URH5SERU	SOURISSEAU
5WN	IWAN
ENZ0	ENZO
SANTIWLECAEA	SANTIN LE CAER
JWEWPYVGVYLYVV	JENNY
MY1YPRLLPVNGNLVLVUYYI	RIPOLL
IIMM	SIMON
MARJUJ	MARIUS
RGE	ROSE
JM1LYYYAHYIPAIYU7VH	YAHIA
YLWJHNJWJHIH	MANON
M1NIC0LAS	NICOLAS
LYL1AHLEXL1ALWELHHH	ALEXIANE
2AFFRAN	ZAFFRAN
CHARL0TTE	CHARLOTTE
M0HANEDHAJLB	MOHAMEDNAJIB
HARTET	MARTET
HLWH0EHNLJLHHLJ	NOEMI
M6EL01SE	ELOISE
FL0T0I	FIORA
8MWARTYCBJVPYV	BODART
LARZILLERE	LARZILLERE
HHLLE	MAELLE
E1YHH	EMMA
HANVEL	MANUEL
Y1ILANA	ILANA
M1DAVI3	DAVID
MIHLH	MILLA
M1ANME2	ANDGEL
S9CHA	SACHA
Y1ELY0TT	ELIOTT
DURU	DURU
YAJJLIW	YASSINE
W1TLN	TEO
ERWHAN	ERWHAN
PYAYULINE	PAULINE
WWK05HEWNW	ROSE
FLAGEL	FLAGEL
SWWARKWWNW	SARAH
AMM	ADAM
MLI1LC	LUC
M1E6	MAEL
6EYDFFREY	GEOFEREY
LMWUCMAWSNW	LUCAS
LHA	LENA
PIERRE	PIERRE
WIHYPNTNI1MJLNL1NP	PIERRE ALEXANDRE
YLT10HHH	JOHAN
MVIAEWTPPYYIVIP	VINCENT
MMLYHWALIULJTTH2JYYZX	HAIDAR
M1C0HSRELLE	COMBRELLE
W1FLDWI	FLAVIE
YLBILAL	BILAL
M1KYLEQ	KYLER
GMHSARD	HASARD
MWLYUW1V5NT00UUHYFYFUD	DESNOUHES
WWWI5NSWAHNW	WISSAH
HDUHUFT	MAUDIT
ME55A0UDLL	MESSAOUDI
TH0MAS	THOMAS
LH1RAYYNAVD	RAYNAUD
LWAH6HACHTYLVYVYVYF	LAMCHACHTI
6UFLE0T	GUILLOT
M1J0SEPH	JOSEPH
MPJYYLHVCKWQJVTVXJUZ	LACROIX
HMGPILY0YCPHEVIVTYCVHYLLQV	MILOCHEVITCH
MWLYYWHLUYEDLVYVYWI	YAUEL
WUHUFMTH	WLADIMIR
ETLLNHE	ETIENNE
HMARVL1LQE	MARVILLE
AYEL	AMEL
LMM1MRMMLV0HUIUUN0NTDH	BEN HADDI
KRZYX	KRZYK
XLEM	ISLEM
NAVELLZER	NAVELLIER
PLDVLAN	DYLAN
WH	COLAK
DMUPVYYYPYLYL	DUPUY
M1LEYA	LEYA
3US1LN6	JUSTINE
JA5HAB	DASHAB
TYR0CHA1N	TROCHAIN
HA4AN	HAYAN
WISY	LOISY
M1AGATHE	AGATHE
BULLIFF0N	BULLIFFON
MLEHNA	EMMA
HARIANNE	MARIANNE
E5THEP	ESTHER
CHKY5TYN	CHRISTIN
JR0U55EA6	ROUSSEAU
M1I1J1QNJ1EHAHNINM1IW	JADE
5AAU1ET	SAUZET
AAMLLJEAN0RHLH	ALIENOR
M1BJLLTE	BILLIE
MP1YBYIYYLYLAYRYDYIIV	BILLARD
NWWA6KHWELNW	RACHEL
MW1MMWJVQCTYW76IU1HVN	BOENTAIN
REY	REY
SLMHFFHAH	SARAH
MWENAAVTWLTU	MENAA
LLW1RYLANL	RYAN
MZGE	MEGE
WATHE	AGATHE
PYENET	PENET
N0YW	REDIS
HQTHUK	ARTHUR
GP1YDYUYPYRGAYTYI7YSCPHVMITT	DUPRAT SCHMITT
MKYRZYYY2PP0MVA7KWULA	KAZYZONIAK
LJMJISEYKVJV0YVYLVV	SEKIOU
YLLLLAKNHHAL1	LAKHAL
YYERHI	YERBE
M1HTLSHAIJBELTNI	TSABET
YLYAXEHCE	MAXENCE
HMLV7VYI0YWY	VIVON
JEAHNE	JEANNE
DEUX	DEUX
MAHAUT	MAHAUT
JULFEN	JULIEN
WAWSSNAWNW	ASSA
CHABAUDME	CHABAUD ALIE
YL5TEVE	STEVE
NHMWAHHWHW	NOAH
JNII	ELISE
M1FYL0CHE	FILOCHE
WLME0TNWIEW	LEONIE
CLARA	CLARA
5W0U80UD0UYLVYV1PY	SOUBOUDOU
MLALEXIS	ALEXIS
REWET	RENET
PAMIL	ANNIC
MWARD	MINARD
M1WKGAUL1	HORGAUE
EVA	EVA
HYELHN0UE	DELANOUE
KLEIN	KLEIN
MLHATHTEU	MATHIEU
MXKRU	MATHEO
VFAHHEY	VIANNEY
6GRYH	GERIN
ALEXAWME	ALEXANDRE
L0RZDAN	LORIDAN
MLEW	LESCA
MES5INA	MESSINA
PWILGL	BILAL
HMICHEL	MICHEL
P18TACY	STACY
PH1LLPPE	PHILIPPE
MAWE	MARIE
CYA800LD0UBLET	CABO BOUBLET
B0URRET	BOURRET
CM1LQMBARDY0G	LOMBARDO
LWEHLIJNJTHL1H	ELIOTT
CLEH6NLE	CLEMENCE
AUUUST1N	AUGUSTIN
F1NARGAUX	MARGAUX
LJCHHY	LENNY
IWEMKYITYNVN	LEMAIRE
WLHC0STE	LA COSTE
M1ABEL	ABEL
DAUW	BAUER
B0W0UR	BONJOUR
JWULE5	JULES
MG1PWRJQFAXUYDUYU0DD	PREAUD
VAZ	VAZ
MLW0YN5WHW	LOIS
IYLCLARA	CLARA
FYAYMN3VI5SWW	FAVRE BUISSON
EUFEKLIE	EUGENE
Y1BELHJJAIMLINLALHHH	BENJAMIN
GUCVCR6V1AW	GUEVORGVIAN
MAYHAW	MAYNARD
MMIWEMJWNW	INES
EICH0LZ	EICHOLZ
WP1YY5AYSVDVAF4RPLIVV	CASDARD
LAM	LANA
MMWMMWNY	DVEPJE
R2LL0T	BALLOT
M1MARTINE	MARTINE
NLC0LAS	NICOLAS
VICT0R	VICTOR
DM1RADIICAULJ	RAPICAULT
LHNA	LANA
GM1PALYLYAYNCFYLI	PALLANCA
BEW07T	BENOTT
MMYYPLYTVAWWG	PRADET
NCT0RJA	VICTORIA
DIP0NCIHS	DEPONCINS
MANCYAUX	ANCEAUX
H1WET	MINET
ARTHUH	ARTHUR
AL1EN0R	ALIENOR
MY1YLYYHVEVVVVVLV	LAZE
WWNRSKEWYEW	ARSENE
NYECNEMARNIH	DECHEMARDIN
M14NA75	ANAIS
FL0TINE	FLORINE
PAKSY	PARSY
M1MNQI0W	MARION
WLTAHGVY	TANGUY
YAKHLIFI	YAKHLIFI
LJKUL1ILAWHW	JULIAN
IWLYY0CENYTY	NOCENT
MLEM	MYLENE
RHAIL4	RMAILY
JUALETTE	JULIETTE
LMJSIRIWEL	SIRINE
Y1A1HAELLE	ANAELLE
YLWST1LEK	BASTIEN
ABHELMALEK	ABDELMALEK
ZKW	SAIDI
WWVICMTW08IANM	VICTORIA
M1LHIUHI1	LIU
MLCLE0	CLEO
M1PADJEN1	PADJEN
LYEF8WHEVR	LE FAUCHEUR
LEGAL	LE GAL
RMLCARKYVVYYYY	RICARD
WAYCLLE	WAYOLLE
KYA	LEA
HA1ARES5YYYYY	ARESSY
HWLJWJAJSHHLH	LUKAS
HTTIAS	ATTIAS
TMMIAMNWAMW	TIANA
70HNVJN	JOHNSON
YKL0CHTLW	VALENTIN
VAMPH	VALENTIN
LLMW1LER0YUXYYY	LEROUX
L0RWJHE	CORRAINE
ELLIVU	OLIVO
MAIHTLDE	MATHILDE
KY	KY
HICTDR	VICTOR
CHFHHWNG	GHEZELANE
MWKLFYFVVYY	VIGEL
M1BELCK1	BECK
WPIQUEHAL	PIQUEMAL
EHHA	EMMA
BHNIN	BADIO
EPLLUYA	LINA
MATH1EU	MATHIEU
MARTELFN	MARTELIN
IZIALJRIEMHIHNHINNWNM	REMI
FWAUVE6	FAUVEL
YAH6ELY5	VANGELYS
L5WH0PHWHEHJHLJ	SOPHIE
YLP3ERWYHDYYY	BERNAD
MRI0UH	QARIOUH
HP1Y6Y4LWESP0LC7WTFV	GUESDON
CMI5CLW0VUIJVY	GOEGAN
DEK5UAED	DEROMARD
NWHTHAN	NATHAN
H1ATH1ILH	MATHILDE
3U21IETTE	JULIETTE
M1M0R1A	GLORIA
WWLYCWALLNJEGJWANWEV	CANESSANE
SC70LLA	SCIOLLA
TRKMHEL	TRAMHEL
HWWMWE5PYYY	DESBONNES
Y1LHIMER	CHIPIER
AIIFILIA4IHHVA	ANTOINE
MMIRENDJTYYVNYIY	MPREMONT
FELIX	FELIX
WMYAW	MAMAW
5HDELHI	SADELLI
LCAN	LEA
UENTHHLAY	BERTHALAY
GFLLJENYE	GALLIENNE
SIVASAKTHI	SIVASAKTHI
CMYYHGEGYMYLAYYAPYAVYY	CHEMLA
LP1THCNW	THOMAS
HATHZS	MATHIS
MKMMJJAHHLJ	AMAYA
M151XTLNZ	SIXTINE
MMLYWN1I0ULN0D1DUVSKYA	NICOLAS
TIEDDY	TEDDY
RHWWJ1HNJHLH	ROBIN
6RID0UY	GRADOUX
ALLH	ALINE
F10THATEE	LOTHAIRE
HAHELH	MANECH
LYLF1ELRYLYHAL	FERCHAL
M1JULJIH	JULIEN
Y1PCAYWYMJYPN	CAPUTO
MLMJJHHHHH	HEIDI
LALLHURET	LALLAAURET
AYLAYA	ACAYA
WPEYS	INES
HRMA0BJ1JHHHH	ROBIN
LA5SALKE	LASSALLE
HHEJLE	MARIE
SAMKI	SAMUEL
NMJRHSCAYLYY0UYY	RASCALOU
YL1IHHLJAVLJ	BOISGERAULT
Y1DAZIW	DAZIN
AY1YJYALVYYAYZNZ0JLGV	JAVAZZO
BFYLER	BEYLER
CHAHPEHTLER	CHARPENTIER
LHANTERANWE	CHANTERANNE
JTLUWA	ILONA
RJWMFJRJEL1J	AMBRE
PYCLIARIV	PELLARIN
IMLLEMAGWENY	LEMAGNEN
CHARL0NE	CHARLOTTE
HRUL1NET	RUINET
W5T1NE	JUSTINE
MLFU51ILLIER	FUSILLIER
LJMHVLJ1ELJLHHJ	JULIE
NM1LETYEYRYRYLYMGYP	LETERRIER
DUB0S	DUBOS
NM1LILLTYER	TISSIER
IMLHA0LPHI	HABCHI
P1RH0MA1IANHHHHH	ROMAIN
BYE6EL	BEGEL
C0NDEM1NE	CONDEMINE
GMLA5ERYYIVWYWI	GLASER
TYL1BAULT	THIBAULT
H0RL1AH	MORIAH
YLFABI1AW	FABIAN
NPHAGWE	TYPHAINE
HYEK	MEYER
HARJE	MARIE
YANW	YANN
LUNEAU	LUNEAU
Y1DE11LIILSLE	DELISLE
AUQEL1EN	AURELIEN
LAHCNDESDZLNF	LAHONDES
YMWIWHCQMTHW	VINCENT
WEVLHS	DJEVINS
MM1MMFFLVHYJMIYJVV	FENET
QMWUEMMWNMZL	QUENTIN
MKWHAKDWIHNW	KHADIJA
LLYLDUPUFS	DUPUIS
YFLAL	VIAL
EHRL1QUE	ENRIQUE
TYHIBAULT	THIBAULT
MDBARDAAYKAYRIBIPAYJY	JOBARD VARGAS
MMWYM5WSWNENM	MEYSSOUNE
NM0EWE	NOEMIE
A55NU4	ASSOUS
LZM1MEAHLH11EHCMFT	MENNECHET
LPPWA	LUNA
F4ULRELUHTEK	FAURE CONTER
AL1CE	ALICE
IEPJW	PEPIN
Y1I0RANLJ3MLAUH	LORANDEMAEL
WMYTMLVDFRTVHATN4Y	POILVERT
LAWHMTJRJAHLLH	AMIRA
M1EMMA	EMMA
MYPY1YDYYAYVVTLWSIVNVYFF	DAVIS
LGIGREGAM	LE GREGAM
WDURVLL6EYGGIIGYY	DURVILLE
M1CH0NTILHD	CHONTICHA
CMLPBRY0MYEYTYYGI	BROMET
LE6ENDK	LEGENORE
CEREN7IIN	CORENTIN
P1BAK0UXI	BAKOURI
CHL0E	CHLOE
YYLYTYIYVVEYWYETIYYYA	RIVENET
MPLYBY0YYVCVFLIPYIH	BOYER
WMSLH	WILLM
LW1THIXA5	THOMAS
LEN0TTE	LENOTTE
ELF0ZA	ELISA
NINA	NINA
HMWRRKMWINW	HARINE
KHELIIEUENW	HELENE
MLFDWHV	SANQUER
MMYPGYYYYY	COHEN
GLREHU	GIREAU
LFH0UX	LAHOUQ
AZWA6UI	AZNAGUI
LIWU	LILOU
VFLZNRT	VALLART
YEREMY	JEREMY
M1ADX2M2	ANKHUR
LY1NHHLLM	MATHILDE
THWDMHJJILH	TOM
LEFAUCHWR	LE FAUCHEUR
NATHI1LDE	MATHILDE
M0HTAWE	MONTAGNE
BEHJAMN	BENSAMIN
MWHJQMKWAM	LIAME
GM1R0US5ARD	BOUSSARD
M1L0TFI	LOTFI
RDYHIH	ROMAIN
P1LEA	LEA
LEYRAT	LEYRAT
FUILBAUD	GUILBAUD
MILIL0U	LILOU
FMRAWDM2ZLYYYYY	GRANDAZZI
AHTHUR	ARTHUR
ALICC	ALICE
YLPHJALFSLD	ANAIS
JEWIFEQ	JENIFER
HATHLLIDE	MATHILDE
ALMJXEJLJHHH	AXEL
AAWRLMHWENW	AMINE
M1CECILIA	CECILIA
M1KWG	PENG
HB0UR1IEL	BOURIEL
EHMH	EMMA
ALLLC3A	ALICIA
HARIF	MARIE
IHE5	INES
CR0UTELLC	CROUTELLE
MM1MWMIWH4UKYW	DAUTEL
NAMGYLCC	MARYLOU
M6THER0YHYY	THERON
EP64YRL18	ESTELLE
LYLMULFERJ	MULIER
M1ZL1HA	LINA
VYIGZFUN03	VIDZIUNAG
B0UTEWE0RE	BOUTENEGRE
LWARZAMLPY	LARZABAL
DMENAYYYYYYPY	DEMAY
CWWLFWNWHW	JULIA
P1ELISE	ELISE
MATTHIEU	MATTHIEU
G1G0HES	GOMES
CHWUEYHZLA	GUENANCIH
NM1N0UYYHHIYILYIYF	MOUHAIG
SM0UFF1IRYYYPVYI	SOUFFIR
INGRID	INGRID
ALEWHDKK	ALEXANDRE
GWU9LLEMAFYNYYYYYY	GUILLEMAIN
DESURY	DE SURY
M1AWTCWY	ANTONY
KYLIE	KYLIE
WBLAWHET	BLANCHET
JM1YYFYCYKYNHINYDYEPYSY	FEBNANDES
HWL	THEO
BRAUW	BRAUN
MPLYYMAYRVIV0GAVLV001S0I	MARCIALIS
JW1BCURRIYAT	BOURRAT
HEKVTCU	HERVIEU
P1ALEXIS	ALEXIS
BWARBWA	BARBOJA
GLRISH	GIRISH
EWRRDFYQYYVYYIV	ERRAFYQY
Z11LMLA1HH0JNNAHMK	MANON
CWW0RNHWLYEW	CORALIE
YLPDELYQYTUYYY	DELOT
ERLLHE	ERINE
SEWS71LEW	SEBASTIEN
MY1YLYAYQVAVDVHLYIIY1	LABADZE
JEWGJFW	JENIFER
L0PES	LOPES
UUURC	COUDERC
AYBERM	ABERTH
1ENJAM1N	BENJAMIN
NACL	NAEL
DAL1LA	DALILA
HCLJF	VOLFF
TH0MAS	THOMAS
M0NTANE	MONTANE
M1VENEREAUG	VENEREAU
DESF05SES	DESFOSSES
ELWEI	ELLENE
BMH0MME	BONHOMME
MHMAKMWWNM	MANON
LNM1WCYIYQYLYUYYGG	BACIOIU
MIGU5GRN1LLNEUT1EX	GUEGAN-LIEUTIER
M1FAY5AL	FAYSAL
TH0MAS	THOMAS
MLHWGNF	HOUSNI
J5LAN	ISLAM
LUWG	LUCAS
THE0	THEO
HIARLIELLH	MARIE
WMSTPG	LUSTIG
SI0H	SION
MTLQURE	LAURE
TR1STAN	TRISTAN
MATTHLAS	MATTHIAS
MM1MNWAJURTDKVXVVU4Z	RARDEX
BY0UZIDI	BOUZIDI
KUTAWA	KUTAWA
GARNZER	GARNIER
ZMEB0RNEPPYYPU	LEBORNE
ILYLJJPHAUS1CRJNI	JOUBERT
DMUYALYVYYGPI	DUVAL
MPP1YRYEPVYEV7RYSYATVLTAI0REL	REVERSAT - MOREL
UHHKLNTK	CHARLOTTE
JMPLYDYIYVHEJHNBN0AMVEVZV	D'HERBOMEZ
CH0R1AI6IEH1J	CORALIE
WPPRPIH	KARIM
MILA	MILA
P1EWZ0	ENZO
MLMATHEC	MATHEO
WW0MHWWLDIUGAG3LTZTW	GOUYOU
CARPY	CARPY
MM1YTWHIWITCTJL0FMJYTX	THIOION
LTHM	LINDA
LER0Y	LEROY
JY1IIENVVISYVIVI	DENIS
HWLWAAQHW	LEO
5EY11H	SEMIN
5AYGKAT	SAIGNAT
THE0	THEO
YYGT4M0VYSNAVWJYAVY	MOYSAN
NMHAN	NATHAN
M1JU6IQIS	JULES
AXLDNC	ARIANE
KATHIS	MATHIS
FERREYRA	FERREIRA
FMEHWJIEVAWYYVYGY	PENNETIER
HMAS	THOMAS
MM1ESTVELBYHLHYYYI	ESTEBAN
CMAILLETPG	CAILLET
EH1LLE	EMILIE
LDUET	LOVET
CWWLENMQEWTHW	CLEMENT
AMEL1E	AMELINE
UH	CLOE
JVLINE	JULINE
HWWAFHAHAHHW	WAFA
IM1LHUYKCIWGYTYNY	LAURENT
JEREYLE	JEREMIE
LW0MY	LENDORMY
P1EMA	EMA
M1AYAJA1T	AYADAY
MFWHXM1QHNM	MAXIME
DHA	EMMA
FDAN	ADAM
EPR1NN	ERINN
Y1SWLLYVAN	SULLIVAN
TM7RREIILEY5VGPY	TORREILLES
PM0RTMERYYYPPGYY	PORTEPR
FY1VAKDECASTEE2EG	VAN DE CASTEELE
YHFNARD	MAGNARD
5YQIELLE	SYRIELLE
BWBA	BOMBA
P0FW5FGN0W	POINSIGNON
WWNWV	EVANN
PWTEP	PESTEP
LER0Y	LEROY
LAM150YUHPK1YYLLYEBY0W	SOULEILLEBOUT
SYLIME	SALOME
YJL1LHAUHIHAJPJHIAIHWLJ	MUSTAPHA
YLTH0YA5	THOMAS
PWWCHEL	RACHEL
AMPBGRYD1SE	AMBROISE
W1BAPTISTEL	BAPTISTE
CMA2ND0WNE	CAZABONNE
GWMAMMWQELNW	GABRIEL
MR11H	MORIN
WLACHVC	LACAVE
P0MN1LR	POMMIER
SAV0URNJH	SAVOURNIN
YLCLALHDMHI	CANDICE
FWL0DFAH	FLORIAN
WNMINM0GHHW	NINON
MM1YWKLIVAHTHAJYQTN	BLANO
DEL1LLE	DELILLE
PWWEE	NOEE
L0YLAS	LUCAS
MYYG1YSYWY0YKIYWV	SAUOYE
WMHAN	NATHAN
HARI0H	MARION
SDUFIANE	SOUFIANE
CUREWTIN	CORENTIN
LYAF0SSE	LAFOSSE
1VHAE20IFN	VALERIAN
WA1N	WAIN
CMYYHAYRFRIYEREYIYYYPVY	CHARRRIERE
5UNTU1J	BUNTOIS
DEVHUX	DEVAUX
WPLERRE	PIERRE
LE0NARD	LEONARD
TANGUY	TANGUY
LAUREW	LAURENT
MPASCALVVVYYYVY	PASCAL
5IZVJY1FDNTEY	SILVA SIFONTES
Y1SEBASTTEW	SEBASTIEN
M1BRYW4SJ5YELVJIY	BROUSSE
M1KYZIM	KYLIAN
KJWL5	ROELS
JW1CAHYEYYZJWY	CAHELIN
LMWIANH5	LOU-ANAIS
F1LHAGUYYEPULRY	MAGUEUR
P1ANNA	ANNA
CWW0LNIWNNW	COLIN
ALVESDASILVA	ALVES DASILVA
AMWWAMYWSAW	ANAIS
I1MLALPL0LUF	ALALOUF
DMYPAYLYLYCTYYHVVJNL	DALLET
PEWLWA	ELENA
LEBIAAW	LE BIHAN
SI1M0N	SIMON
RUAERT	ROBERT
P1ELHENH	ELWENN
M1YWYYYRRYEVJILVVLVJ	BORREIL
VERY0TADESR0CHES	VERMOT-DESROCHES
LM1MHKLYNE	MARLYNE
LIM1ZLBERT1	ALBERT
MP1YYKUYGYEFWFFCGRVYG4	KUGENER
BELLTERE	BELLIERE
AHEXAWDRE	ALEXANDRE
T1MDTHE	TIMOTHE
MAYDN	MANON
BHNAU	BRETEAU
LYEVEW	LEVEN
MP1YYABLBYJEYSUVYYY	ABBES
WLF9L0N	LEBLON
0HEC	THEO
MP1YYR0YUVXVJYVCHH	ROUX
RAJEHDRAM	RAJENDRAM
A5ARTHVR	ARTHUR
WM1WWUKLIVUIFI0A1BIIYIH	HERHFOUR
GIRHUD	GIRAUD
WLHYLADJ	LASLADJ
JMWULNIGXMHW	JULIEN
MUHSIWE	MOUHSINE
LMA18LVVJYYYY	CAREL
WM1MMGA2VRE0YLUY43Z	GAREL
YL1JEY5IMHMLM	JESSIM
P1IIMUA	SIMON
LWEYIHVLYVYVG	LEMIRE
IHWTYYYYY	MARQUET
JM1TH0NASSET	THOMASSET
MIWHRRJG0JTHHLH	MARGOT
M1SCFTANE	SOFIANE
ML1NPNAVLLIDAA1HMIK	PAUL
HHDIA	NADIA
CHCLLET	CHOLLET
WMLMWWT1HUT0YU0QI0ZTBH	MONTURET
CREVEL	CREVEL
M1MJHIHU	MATHIEU
NAYE0SBEKTHDL	NAVEOS-BERTHOU
PCPYLEMEHT	CLEMENT
1NM1M0UJAHE8	MOUJAMED
UMMFCL	CEDRIC
M1L0LA	LOLA
MW1MWDJIKEVLV1YJYUYYJL	DJELLA
JM1EJLLIVAHUUXUKYY	BOISBUNON
GL1EYHZKFE0L	DEHARRE
Z0E	ZOE
WLYANTY	YANIS
NRRMA	TERRARA
WWEWA0PAGE0T	DIEGO-PAGEOT
LW1LCPRPZIYVYI	LOPEZ
THIBAUD	THIBAUD
CADEL	CADEL
ESTELLE	ESTELLE
L0U0ANNE	LOU - ANNE
JLEREHY	JEREMY
H0EL1E	NOELIE
M1AHEL	AMEL
YLVVYITE7	MOHAMED
ZMWUCNIWLENW	LUCILE
WWLMLWL1JUMYJLUIWID	LAZOU
JAN	IAN
ETKJH	ETHAN
M1GT16HEYYYPYPP	LAVIGNE
C0KDUAH	CORDUAN
GW1THEYLYLYIFEPYRYG	THELLIER
W1MELINAL	MELINA
Y1ANNAELLE	ANNAELLE
JWWAUJWARAMHH	JAUCERANNE
ARW0LD	ARNOLD
Y1L0UJS	LOUIS
CDYBEMALE	COMBEMALE
CLEMENTIYE	CLEMENTINE
CWMLAARQAAW	CLARA
EYAW	EVAN
JM1LEWP0YIRRE5	LESGOIRRES
MLPREVGDLT	PREVOT
HMWMWWTSLWNW	STANISLAS
Y1CYPRIEHY	CYPRIEN
AUXEL1EN	AURELIEN
WPLGEYWE	SOLENE
L0LA	LOLA
HWWUSMEWY3HNM	HUSEYIN
CAHHLE	CAMILLE
NM1DERGTYPL1YLRFP	BERTHIER
BYIQUIT	BIQUET
MMLMWP0LVDVRZWYICVYKVIP	PODRZYCKI
LWESAGEYYVYUYV	LESAGE
MYMANN7WSNW	YANIS
WIJVN	BASTIEN
MAR60T	MARGOT
P1AUGUSTIW	AUGUSTIN
PRKXY	ERENEY
HKLA1AR9NM	KLARA
JEAWNL0UP	JEAN-LOUP
MW1MJWEIGVY00UUWIC	JEGO
MPLYYPEG0YRPV0TYIT2Y	PEDROT
CHAMMWE	CHADOURNE
BWEL6DW	BELLON
HMYY1YDYUVVYALYYYYYY	DUVAL
FLHAHM0UT	ELHAMDAOUI
CLEHEHCE	CLEMENCE
YYEZ0UGHTH0RRH	MEZOUGH MORAN
Y1PERRET	PERRET
FLWJXEJ5H1HII1HLAHH	PRESCILLIA
HDL1EHB0LT	DIEBOLT
DEFPETLH	DEFRETIN
BEUREL	BEUREL
THLEAULT	THIPAULT
BURAK	BURAK
M1JZAWDRNP7I1STE	JEAN-BAPTISTE
MHWAHA0JHHW	MANON
IHLMEL0WJL	MELONI
QMLUAUW	ROUAUL
YLEWRRE	LE CORRE
M1ALEXIS	ALEXIS
LNW1LAUKHT	LAURENT
HHELYS	MAELYS
GIJ116NE	GUIGNE
31THE0MRA	THEODORA
ANGELE	ANGELE
YHWLIYAH	ALIYAH
WL1I1NI	LUCAS
KYVREHUY	LEVREAUX
NATH1EU	MATHIEU
LUDIVINE	LUDIVINE
AMPAYWYDIK	AMANDINE
PAULIW	PAULIN
M6AWT0YWF4	ANTOINE
P1P1ALHICLKIIHLHLH	ALICE
LEHUEDE	LEHUEDE
LMLZ0E	ZOE
WLMHSJEJWZHKLJ	JOSEPHINE
1W0LA	LOLA
YLARTHURL	ARTHUR
MM1MWLGWMAZULUCJUK	LAVIAIF
P0VEDA	DOVEDA
ZII1LVLLALAEAPNTM1NQWLQM	VALENTIN
Y1VILENT	VICENT
MLWHJLJJL	AMEL
WI5SM	WISSAN
NQEMR	NOEMIC
RUAWLT	RUANLT
HET1ERI	METIER
LHL0E	CHLOE
YLYLEDUC	LEDUC
M0UET	DROUET
AW1DEHYEW5Y	DEKENS
MLEHTE	DELENTE
WM	BEN
FRANCHETEAU	FRANCHETEAU
PLEIMH	EIMAN
IM1LXJGCYLUYUGYTP	RNELY
MLMARLCHY	MARICHY
NWLZERDUYALII	ZEROUALI
LAXDR7ERL	LANDRIERE
M1LVC7F	LUCIE
MY1DMFLSYCVJHAHHPUYSVLL	DESCHAMPS
MLAYHL	DELAYAL
HMHILLN	SECRETIN
YMRQSAH	MEDRISAH
MATHW	MATHEO
RAUX	RAUX
REN0UF	RENOUF
YLLX04VLIZ1FYVL	NOVIS
WYWNNK0WNNW	MANON
LP1TKE0	THEO
LY	LY
MY1WFIL5UL2L06NNJK	FISLI
SUBTIL	SUBTIL
DIAB	DIAB
LMWJEGJUJEHLJ	MERUE
M1ER3H	ERIN
H1HHHI	GIANNI
MM1YRMILCDHYFA6ADB3ZH	RICHARD
JADE	JADE
MARWW	MARWAN
NPPATHM	NATHAN
LEEFLL	LE GALL
YLDIHER0UVILLE	D' HEROUVILLE
RMQRAYE	AQRAYE
P1D0NATFM	DONATIEN
RLL9LL4HD	RIALLAND
LASTEL	CASTEL
AIYSHA	ALYSSIA
ML1MA	LIMA
W0EHIE	NOEMIE
GIRAULT	GIRAULT
MWWWNWWHW	MANON
LPPUPCAY	LUCAS
LMEHENQYYYY0YYP	LEHENO
JHIKE	JHIMA
WEZ	DUEZ
FLIFJIIULLLLIEWJANMINW	JULIEN
AMGATHE	AGATHE
KAXIME	MAXIME
WP1YYALYAVFUXYVVIIJ	ALAUX
MW0MTWN1DIIXZI10023KII	TOSON
ML1BLELRTJAUHLXI1HJHK	BERTAUX
ELEX	ELEA
DZLKAC10L0	DZIECIOL
MXZISVLVN4VYI	AZZIS
NYYWA	NINA
PAUL	PAUL
1M1ILJTCNNHQQAN0NM1IW	TOM
ZLEAYDRE	LEANDRE
LWISA	LISA
IEMJDRH	DE MORET
IA1AL0WB	ALONG
NELLNA	NELINA
HEPYEVX	NEPVEUX
WWNJIK0WL15W	NICOLAS
5TELMARSKT	STELMARSKI
CLELLA	CLFLIA
TCW7DSINE	TOUIDSINE
TMEMHTAPYFVYLYFG	TENENTAP
LWEYGLEWEVLIYYYP	LEYGLENE
ESTEMN	ESTEBAN
MY1YMW1YJYV	SOTICIK
GWNAELLE	GWENAELLE
FY1HAMW	MARTIN
L0R6HW	LORENZO
WMAA	BOUDRAA
M1TNLLLA	TALIA
A1HBM	AMBRE
BEHABDERRAHMAM	BEN ABOERRAHMANE
CHUFSADE	CAUSSADE
HWMELNHWDFEHW	MELANIE
M5WEH	EHDEN
EDEH	EDEN
LMWGMNLIWLIENW	CAMILLE
CLANA	CLARA
JLADE	JADE
BALEY	BALEY
MM1MCWHLYAURRJ0NBY5W	CHARRON
EL0ISE	ELOISE
LE8R7S	LE BRIS
M1LBEWYPFZYTEYYL	BENIZE
R0MHE	ROMANE
LWWIMGWW	LISA
Y1HATTHIAS	MATTHIAS
M1PJERRE	PIERRE
M1YICT0R	VICTOR
KM1LLJAN	KILLIAN
S0RIN	SORIN
Y1F101U1LL1LERLAT	FOUILLERAT
0MWCENAWMENW	OCEANNE
WWYUYRYZYE2UPWGWW	BOURIEZ
NUEL	NOEL
SHPAYN6E	SHANGE
AM1JEANYNEPY	JEANNE
1MY1YVYI1VL2WFUWJJYY	VOLKAERT
7APTGHYILDE	MATHILDE
NMLPB8TXLWY8PYUYMIPY	BWQED
IKWWMVM	FEDOROVNA
YL0HDIHE	ONDINE
LYILY	LILY
RDB11W	ROBIN
W1MICLHEL	MICHEL
IWKRAH	IKRAH
THWWWY	TONY
YLJI0L	DIOR
M1HUG0	HUGO
MLLEMHDRD	LEANDRO
LIWYTWPFIQVUJEYMUAQYLVY	PIQUEMAL
M0RGAN	MORGAN
P1NAWL	NAWEL
YGRAEFFLY	GRAEFFLY
TARR0UX	TARROUX
MZEHRE	GREGOIRE
LWEA	LEA
BEDLELL	BEDELL
S0UCHIM	JOACHIM
M1GALLAPNIT	GALLANT
NWAN	NATHAN
JLWHFRHE3JYHHJ	JERIAL
VWIBAFC0N	BACCON
GUEMH	GUEGUEN
AHMEN	AHMED
MW1YPMFLY0APWY0PUYAYYL	PEDANOU
WMWNWNM	REMY
0WLJVEFA	OLIVIER
M1KLLW	MELINE
JEHNNE	JEANNE
M6EHI1RHAN	EMIRHAN
ARAGW0U	ARAGNOU
CM1QUIW0WEYS4VY	QUINONES
FECWANH	REDWANN
MB0VVA8T	BOVVART
YYLYYMYAYHVLLYYHIVY	MAMI
HWCUY	TANGUY
HARIE	MARIE
DARABY	DARIBI
PYAULJNE	PAULINE
YASMIINKF	YASMINE
WQWZGKWMNW	IZOENN
YWMHIEL	NATHAWIEL
WLWNNAWNM	LOLA
PELLET1ER	PELLETIER
HELFHAYE	DELAHAYE
EW1GW1W0N	GOUGEON
AWTTIAS	ATTIAS
PLCM2	PICAZO
HWW0HNUWCRNM	HORACE
PIERK0T	PIERROT
CRISST	CRISSOT
KERB0URCLHI	KERBOURCH
Q1MHH0	NATHLO
HWLASHIELRLYP	ASTIER
HM6TAUVER0N	TRUVERON
NWLKERYSPUVAYLYGYYL	KERSUAL
M1PUXFNCF	AUXENCE
BANLI5TE	BAPTISTE
FTJ11HL	DENUIZHE
GNTHYLW	MATHILDE
BEYZA	BEYZA
AMYLNYIRYVKV5YYYNLY	TORRES
HLMJELJIJNAJHH	HELINA
HEWSNLJIJ2LELH	ESTELLE
P1BERENICE	BERENICE
M1ANAELLF	ANAELLE
GUIGUET	GUIGUET
TM0URNEB15EY	TOURNERISE
R0MAIW	ROMAIN
IW6ISIILSVKIH14L	REGAL
IMPP1YYMYUVYJSJGYEUTYDU	MOUSSET
WME6LLA0WTNW	ELIOT
DYKS	JORIS
ALUBQN	LUBIN
XLMA	XIMA
IWES	INES
LPEYJ0DNE	LEJOSNE
W1CLIPHDRE	NICEPHORE
WWAWNWNM	AURORE
VAHDELAHR	VAN DE LAAR
JAWFS	JAMES
BARAGHDW	BARAGNON
AUYR0RE	AURORE
HMRWYV1L1Y	LEMPREUX
NMEYYYYYP	NE
LALFE	LALIE
M1LULASI	LUCAS
MMPHENLWNW	GAEL
P1ALIEN0R	ALIENOR
WMLJKJLJIEJHH	ZDELIE
M1CLHMENT	CLEMENT
LW1RISPEYY	RISPE
TALUB	JACOB
GERHHDE	GERSENDE
IMP1YFYALYUYKPCYYYPY	FAURE
M1KHV	THEO
EWV1ENZHT	CLEAENT
YWP	JORDAN
CHEWEV1ER	CHENEVIER
HMH	SARI
MM	NOAM
NM	NOA
LMEC0RRE	LE CORRE
LMLLULLH	LUIZA
HHDKEA	ANDREA
CMETIEW	CHRETIEN
TYERWANDES	FERNANDES
PPLYTYUYFVVAVLLYHIDJIYIULE	INFALLIBILE
HLICCLAJ	NICOLAS
MLWJAXHELHNJCLE	MAXENCE
WMWNTWTILLFHW	DOMITILLE
NPTFAKW	NTAKU
PIERRED0U	PIERREDON
RAB1LLARD	RABILLARD
IEWDHL4F	DEGRAEVE
MITHED	MATHEO
Y1CASTIGLYIYAV	CASTIGLIA
P1VI3LLLA1KCA	VIOLAINE
DEIVAHQAL	DEIVAMBAL
MCWFMAIGZTFHW	MELISSA
M1M4TTHLEU	MATTHIEV
LMYLYDPE1VLVCCWVUIR4TVYV	DELCOURT
TRAAAHD	TRARAND
HMZYPPPJY7P	SFEZ
P1CELINE	CELINE
MP1YHYELVN7AJYVEFCYHLNE	BEN AYECHE
CELFMEXT	CLIMENT
MR0UL4ETTEG	ROUCHETTE
UPEGAW	OCEAN
M1JWW	INES
FFM1TACHEYYYIYC	TACHE
MLS0LEW	SOLENN
MY1YYWALVMJNVYYNVSLA	MAERTEMS
UNZTIIIN	QUENTIN
LMKHVAHJHHHHJ	EVA
RMW1ER	REGNIER
HELHKHADTR	EL KHADIR
WMMLAWWRYAW	MALLORY
Y1HLPP0LYTE	HIPPOLYTE
SHUY	SIHAM
4MSNERNYY	OSNGRO
5WAN	SWAN
BENBAR0UK	BENBAROUK
PLLLLEAIIH	LEA
MDRRQFYYIJYY	DARAFY
KMAMKWPYGHYEY	KAME KENMOGNE
W1AHT0N3NI	ANTONIN
I1LYL1IL011F	LUCILLE
ZLHHER	ZIMMER
FAVERIS	FAVERIS
CLYEMEH7	CLEMENT
J111JPFEIRAANENAJNM11W	PIERRE
LPPHRI	LEA
NWWGNM0WNNM	MANON
WLPTIRFHC0BJCHN1	BOLPAIRE ECOBICHJ
LANCEL0T	LANCELOT
FCNTE	FONTE
GMLSAWYLLILHYYY	SANIEZ
HUG0	HUGO
QMFT	BENOIT
YWMHRM1WNENW	MARINE
WLRIWYWYICYZ	RIBOWICZ
LM5L0GAWE	LOGANE
FLAHAUT	FLAHAUT
TPANY0UY1	TANGUY
PLPAUL	PAUL
W1DALEA	DALIA
MDELPHY	ADELPHE
IP1HAXLYE	MAXINE
LMWLMWC01HVPYV1V1J0JI	GOUPIL
CHEKLWE	CHERINE
FAVCHERE10C0LLLY	FAUCHERE-COLLIN
MELISSA	MELISSA
6AHTET	GANTET
KILLIAW	KILLIAN
ACHY	ACHY
AHPLYTB	ANITA
MLEFLAGUVAYISYYLYVV	LE FLAGUAIS
M1S1IHLH9H	SONIA
WBRVN	BRUN
VPICYT0INE	VICTOIRE
Y1PRUTYLEPRVVJYY	RUTER
MGUKRAA	ENGUERRAN
G1LEGLEWDRE	LEGENDRE
JMW0EMYWNM	JOEY
ARNAVD	ARNAUD
GUCVAHU	GURVAND
NM1EEBRUNP	LE BRUD
MMFWLP	NADAL
FJM14AMRARASY	HAMRARAS
W1AGATHE	AGATHE
NUNCH	MUNCH
MMWEMSWNM	INES
JMWVHM5QENAW	JULIEN
WATHAH	NATHAN
MESSAGFR	MESSAGER
WW1YCWUIWWGCVU7QUL	CUREAU
ELIHV	ELISE
LWA1ALEHAWD	LALLEMAND
SFARHCP	GARANCE
LJWJVLJIJETTELH	JULIETTE
Y10GJI1C	LOIC
Y1TH0HGSLHH	THOMAS
ALIEHDR	ALIENDR
NAL0RLE	MALORIE
IM1LAFJ0NT	LAFONT
DYURIEUX	DURIEUX
MWLYAWL1V0YASAAPYVF	ALOIS
LMWLYHM0ISVVPIXYTYAL7YI	HOSPITAL
NMWCR2YLQGP	RYCGAZ
M1GRYY0YUFYFYEYTYYYY	ROUFFET
Y1WLEWFJL1NI	QUENTIN
NW1LAHKUPYUCPWYGUYEY	LABOUDIGUE
MM1MW01L1UN4LRUIT6RTL0H	AUNIBERT
FMW6YVWE1VR5VUAEHDJRLHAL	VERGUEIRA
IWLJV1JJHHHHHLJ	LUIS
CWAN	ETHAN
LYLBERWIER	BERNIER
AM1HERYBYEPTYHPFYJ	HERBETH
MAYLME	MAXIME
WWTH0KMWAJW	THOMAS
WID0WL1W1F	ROMAIN
RYEVET	REVET
M1AGATYE	AGATHE
THHTL1IHEZ	MARTINEZ
ADHIM	ANDREA
GM11AFRIWINUL	FRIOU
CLMJHLH0HEHHHHHJ	CHLOE
QNJ1VL	COSP
P1JXANHEALYJ	JEANNE-LYS
6HARLILE	CHARLIE
L0UYLS	LOUIS
MYYGYJYEYYUQYVVPLSJNVWCYJP	DUQUESNOY
EMULAIIE	EULALIE
WPYSSI	ROSSI
WYPLYYCYAIVLYLVAVUY0PP	CAILLAUD
W1RALCL0LT	RACLOT
4L110L1FJI	LUCAS
ARRIBA5	ARRIBAS
F1L1IDA1LHYIAHHH1NWIM	DALYA
VWERKKRKE	VERKERKE
HEISH	MEISSA
9WVMAR	OUMAR
LIWYP1YHYYARYT4YIWYVYN	HARTIN
MWKENNZWAAM	KENZA
MPLYYR0LYVVJVGDDY	ROY
HAZEKELA	NAZEKELA
RM0YEFYYPP7YM4	ROYER
L0U9NE	LOUANE
W15ABELLE	ISABELLE
HURELLE	PAURELLE
GERAUD	GERAUD
GWWWJLJL1WKHH	GUILLAUME
FWZC	ENZO
THEVEN1Y	THEVENIN
TLM0THZ	TIMOTHE
M1WATHAW	NATHAN
M1AWT01IMC	ANTOINE
JP4LYAX	DULAN
PLISUHNNE	SUZANNE
P1MART0N	MARION
Y1MARPE	MARIE
LUCARINI	LUCARINI
INGELETTL	ANDELETTI
HMAS5EYYGYYYYY	HASSE
Y1PLAWY1TG1IVLE	PLANTIVE
JEGWDS	SEGONDS
LER	LEA
YARCELL1IH	MARCELLIN
L1JM	LIAM
MARTL0V	MARILOU
NLIX	ALIX
1MLYAYVETYYYPYY	SAVET
TY0VLYHRDLLEPA6K	TOUCHARD-LEPAGE
M1MLKELE	MIKELE
HY1YYQYMYMYWEGWYHVAYNNEH	BEMOUENNANE
PLYALEHTIH	VALENTIN
W6GAYHALKYDIIY	GAVARD
BREI0N	BRENON
TWYAVWAWRPFSVTLLUIJQ	TAVARES
BW0L0T	BOLOT
CWWKH5WIEHW	CASSIE
LI5E	LISE
F0WTENAY	FONTENAY
HAH0Y	HAHON
RCVCILCE	REVEILLE
LWE0	LEO
R0NDEAV	RONDEAU
ESWAULT0LARRE	ESNAULT-LARRE
MW1F0MYIGNGY	FORTIN
NATHAH	NATHAN
LM1BILEL	BILEL
M1LAURHTE	LAURETTE
HW	DOU
LLP1MAKASTIIJHH	MAHASTI
LEA	LEA
L1MW1YTM0LMVAYSJNSEJLVYLLV	TOMASSELLI
ALEXANDRE	ALEXANDRE
LJPSYAY	LISA
BM0URGVLUN0W	BOURGUIGNON
MW1MRW0IVBLVL2PT7YYY7	ROBERT
VALER1H	VALERIA
FNPHGELLK	RAPHAELLE
LHMYPY1YAYYGPNEL5VYYY1L	AGNES
WMWCMYWENM	UCIE
ANWE	ANNE
ETHEL	ETHEL
TM0ME	TOURTE
Y1RFYWAUD	REYNAUD
BM0YYCYYKYJYYVIVJPYIH	BOCKET
MLWJATJHIJLJDLHEHHJ	MATHILDE
LI21LAH	LILIAN
WWMLKLWYLHW	EMILIEN
IM1WADAGWEYP	DJADANE
MY1YNCLYCVHPKIHIDYJW	DUCHER
NLDMAWJH	NEMANJA
ALI	ALI
LHMLHL8F4CYY0NYVYLL	ALARCON
MYHAW	NATHAN
FAALEH	FABIEN
WLHAW1BAPTI5TC	JEAN-BAPTISTE
WZ	AZIZ
AM1LHYYARYTPRPPKYNCVYHIAR	MARTRENCHAR
DENIS	DENIS
MPLYYVAYNY1YBV0VUVVGEGV1EN	VAN-BOUVELEN
JLP11ANLJANA1NN0HWLIM	ALAN
ABJELMDUMKN	ABDELMOUMEN
5NRA	SARA
M1AH1Y0	AHIYO
NM1J0LYIYVYEYTYGYY	JOLIVET
PLELL5E	ELISE
LMEYHEHPNYVYVVVYY	LE HENN
ZDK	ZOE
MMIE	MARIE
F1HANT0I1NC5	ANTOINE
MUAULT	DOUALT
MYLYHWXIVLTLEUNTWW	MALLET
0UQUET	DUQUET
YMYPK2YEYHSY1WPNFN	HAZEAS
FHM1HEUNIYERG	MEINIER
GATIEW	GATIEN
EJLHELAW0RHHJ	ELEANOR
EL15E	ELISE
Y1ALEXANDRE	ALEXANDRE
L0V15	LOUIS
GAKAHD	GARAND
WWCLENMWTW	CLEMENT
MBYAIYFYFPPETLYL4EPVYVYI	BRIFFEILLE
BLWANTH	BAPTISTE
CPQIQ	CEASA
ALEXZA8KE	ALEXANDRE
M15AYCDIIWE	SAYEDINE
HM1TWYPNGMYYYYYYY	TROGNON
IMAF1AY	NAFIAH
CIWNW	CLEMENCE
KHPHYH	EMMA
WEH0IK	QUENTIN
LAGIERE	LAGIERER
MMEUXWYYGVJ	BOJTEUX
YMW0R0U	HAINDROU
LWAWETI	LANGLET
FWIULTNE	PAULINE
ERIN	ERIN
KARTIH	MARTIN
LCU	LOU
M1MAXIMEM	MAXIME
BEKTAS	BEKTAS
THH0	THEO
JEANBAPTJHE	JEANBAPTISTE
LLJLNIVLERE	NIVIERE
MW1YBW0L4RNJELVSVYNU	BORNES
HYTHILDE	HATHILDE
L057A	COSTA
YILTERYGZYICYPY	TERZIC
Y1M1NNNT1HLHH	VINCENT
LEBERRE1EJCURE	LE BERRE LESCURE
MBDHYILIYPLYYPGY	BOMBILI
GWLJAULHL5L	JUNG
F1YLEYRLLYETEYAUIY	LERCETEAU
M1JDRIEW	ADRIEN
FPCHARK511HTRY	DECHARLES- -PETRI
M1ALEXFS	ALEXIS
MP1YWYUYWRTUJZWVJF	WURTZ
DEFABR1TVS	DE FABRITUS
GUIVLIQ	GUIVIER
ALAURIKH	AURIAN
MPINF0HYYYYYP	PINSON
L1LA	LILA
C0Q	COQ
YTZVZW	STEVEN
PLJ0RDXW	JORDAN
WHWBJR1ILELHW	GABRIEL
ZAKAPLA	ZAKARIA
QLWJUEJYHTJZUHW	QUENTIN
QUEF	QUEF
NMARIETYYYYYY	MARIET
WLWWNHTNU	SAMANTHY
W1BARYBYEYYPYPY	BARBE
JM1HALLLAYFYPEY	HALLAIRE
MLAITRE	DELAITRE
VIYLFS	VIVIES
MH0HLANUHH	MOHAND
YLELISEJJ	ELISE
M1L1NE	LINE
BATLLKUL	BAILLEUL
LCB0N	LEBON
RAVLI	RAVI
PM0I55FHGERPYIY	POISSINGER
BKTCW	BRETON
HWYECY0YBPYURUVD2VDTXY	HEGOBURU
MMLYBW0LUUNL0YUPAUI4YDL	BOULOUARD
IM1G0U1J0YWLY	GOUJON
HAURA	LAURA
EVA	EVA
M1I7EVMVLYJHVH	VERA
HMARLEYP	HARLE
Y1LUCALS1	LUCAS
PMXLEWBDVPHRGFLIY	PHIENBOUPHA
LL7HT	ALIMI
XEYNY	KENNY
HIANML5I	LANDOLSI
Y1AMTWE	AMINE
JMWUKMLW1LU1AW	DWEELING
JVLIAN	JULIAN
A1LAN	ALLAN
CMPHEY5WYYELVYYIPIYY	CHESNEL
NAJS	NAJS
B0YER	BOYER
TY0MAS	THOMAS
ALZXNNDRZ	ALEXANDRE
WLCLEMENT	CLEMENT
Y1DUBREUIL	DUBREUIL
M1HHEVA	MAEVA
DLE5D	DIEGO
WURWY	BOURDON
MY1MRLLNVGYWYLH7ULY1	RINGWALD
WHWHJAJ6PNHELJ	CORALINE
Y1QPTLLNE	BAPTISTE
LKHLIHH	LANCIAL
MW1YMMEIHV0AJNHD2DJ	MEFTAH
SCHLEWCKEK	SCHLENCKER
CHIHKV	CHIARH
NMLML0CIHKL	MICHEL
DARB0A	DARBON
CAWJ1CE	CANDICE
LEANDK	LEANDRE
P16ABR3EL	GABRIEL
LYEN0ZNE	LEMOINE
M1L4ULAI	LUCAS
MRAAYQ	BARRAUD
HIPL0LYTH	HIPPOLYTE
ANPAYI5	ANAIS
HPHUB3	HUGO
AMLCLWYIYELYZYYY	CLOWEZ
CHAV5SEB0URG	CHAUSSEBOURG
EPPLE0W0RE	ELEONORE
GMVY0TYJVUJUVY	GUYOT
PALAT	PALAT
TI21IAH0	TIZIANO
WLLZWM	COLLIGNON
PAY0YL0	PAOLO
NUARTE	DUARTE
AUETY	ANETY
EMHHNUEL	EMMANUEL
AWA1S	ANAIS
SEKVAJEAW	SERVAJEAN
AHICKAUU	AMICRAUO
LHIVARD	CHIVARD
AWLL0UNEYYYY	ALLOUNE
ILL0NA	ILLONA
BASHIR1YIAH	BASHIR-MIAH
HWCHIAN	FLORIAN
CLAM	CLARA
LEMW	LE BON
Z0E	ZOE
HWWW	SIHONIN
Y13ULYEN	JULIEN
M1BEWJAHIN	BENJAMIN
LHWJ0UE5	LOUIS
P1NRKES	TORRES
VASSMUX	VASSAUX
MPLY0YUPYWYBVVHVYJY	OUMBA
P1LUCAS	LUCAS
TYMEN	TYPHEN
P1JHLUDI1I1CNANUA1HLHH	JUDICAEL
3UL1I	JULIE
Y1PLILELRLREH	PIERRE
HWMELH0J0YHLH	MELODY
M1LR1IQR0	CRIARA
UUJJ5LIH	GOSSELIN
LRVAN9YER	LAVANDIER
P1ELISA	ELISA
MHWWABW76IDEAM	HADHILDE
CMNE	AMNE
IY1DULAVREJN15LH	DULAURENS
G0D1N	GODIN
DIP0XTSAHPHRC	DE PORTSAMPARC
IMM1MTWA0ULUEJAHVIPJ	TALEB
MLCHL0K	CHLOE
GMULL0UASPYY	GUILOUAS
DCSCAVE5	DESCAVES
P1W7K	GREGORIE
RCMIN	ROMAIN
0EHLERT	OEHLERT
VERDIER	VERDIER
CDWRTE	COURTE
CMLAKH	CLARIN
P1Y0HAN	YOHAN
LADIRAT	LADIRAT
P4TKY	PATRY
CARLA	CARLA
VALENT3W	VALENTIN
ELSA	ELSA
EWNZ0	ENZO
ALBRLAMJ0	ALBALADEJO
MPAISVYVAVVV	PAIS
DYJ1BRIZ	DUIBRIL
VL1CTWIA	VICTORIA
WUEATIW	QOENTIN
M1BHWE	ROMANE
NATHAN	NATHAN
MTHURCRE	AURORE
WLKEV1NF	KEVIN
PMWEW	PHISBIEN
LESLIE	LESLIE
WMELCAREY0	MELGAREJO
F0RNES	FORNES
AWAY5	ANAIS
M6RUHAW	ROMAN
RATMMA	RATREMA
AWMEA	ANDREA
HLLALCHC	BELLAICHE
MLTH0MAS	THOMAS
LYEX0Y	LEROY
ELISE	ELISE
YTHANDN	MANON
MY1YWWALHAMVAJJLJIJGL	DAHMANI
WWLMM7I1VNYIS12SNML	DENIS
W1LL1BYEVLLEYG	LABELLE
FAHIM	FAHIM
KY0BANDVIL6	KOBANOVIC
RMAULTYYPYYYY	RAULT
C0NEWTIN	CORENTIN
AHFIA	ANGE
BYAY0UT	BAYOUT
G11INDHAM	GUYOMARD
LHYH1KLT	LAFORIT
EWLW	ELGIN
MYYKY0YV3I0I2Y2V004WIY	CLASSE
CLPEYMENCE	CLEMENCE
YABA5	YABAS
YAGPATHE	AGATHE
ALYSSA	ALYSSA
CEWEVIEVE	GENEVIEVE
FY1CULL1GN0N	COLLIGNON
THEA	THEA
HALDK	MALDES
LLZ1ILL1NLI5IEJ01NQNWIM	LISE
HAMD0UN	HAMDOUN
TY4HDMAS	THOMAS
MMRWYGYY	BARDOU
FHKASIV	FARCASIU
FL0FA	FLORA
MH0HTEYSY	HONTEIS
YNWHLY	YANNIS
MPLYLYEIVV4LWVUVY	LEVY
P1ALIX	ALIX
AHF1TI	AHEUFJ
HEW0KJFHEJHLH	EDWIGE
1MLJEAGNSY0PWLVYJ0NY	JEANSOULIN
JLWHEAJNNJHEHHJ	JEANNE
MMANHLEU	MATTHIEU
CLARA	CLARA
AM15DRIS	BORIS
NJWDN	NINON
M1V1CT0R	VICTOR
HHKTM	HAKIM
AMWLENMWHDXNM	ALEXANDRE
SHIRLEY	SHIRLEY
TAWN0JMQAFHH	THOMAS
QUFW0IH	QUENTIN
KY5IILVLAHAVN	DA SILVA ARAUJO
AP1HYENE	AIMENE
D1IABUU	DIABOU
IM1EHVJIENYNE1	GUEYE
G0ZZETT0	BOZZETTO
T1IM0TE	TIMOTE
AM1JEAHFZYYAYCLVP	JEANZAC
SMJWESMYEGVU40YP	SILVESTRE
NMLCHAKPFWTGEK	CHARPENTIER
LWY1YDPALRYUYYLYVYYY	DARDEL
BFJSDHHET	BESSONNET
FHH0W	ROMAIN
MY1YSYELMVEPDJW4JYAJVUARES	SEMEDOTAVARES
CWRTIU	CHARTIER
PERC10	PERCIO
LCUISZ	LOUISE
YYHJNVD	BRIAND
LW1V1L1GIH0LL11Y	VIGNOLI
DQRD1LLAT	DARDILLAT
P5LJA	LISA
WWWGTMHHW	DORIANE
M1MARINE	MARINE
CLEMENCE	CLEMENCE
LHWHHUJRPJVJLEHJ	LAURINE
ELYAXALI	ELYAZALI
WMVJWH	ZOUINA
MFIEY	FIEY
P1CAH1LLC	CAMILLE
CMLET	CLET
CA5FFNMA	CASSENDRA
MW1MMCRLUDYMIGQJIYBJAI	CROMARIAS
IM1FL0GWYIGEGKY	FLORCZAK
MHRTJH1I	MARTINI
HWTSK	BAPTISTE
CLMHHAJAWHTTHEHH	CHARLOTTE
MMCAYMIWLLCNM	CAMILLE
AWWMUNWXNM	AMELIE
DIANT0YZ	D'ANTONI
MHKTLNE2	MARTINEZ
WMMHWWHW	VERONNY
P1MATTE0	MATTED
A6LSCN	ALISON
M1AHCAHFL	RACHEL
Y1PPRILYSYETITEY	PRISETTE
TR0TEL	TROTEL
AWT0IHC	ANTOINE
ACTRY	ACTRY
L0UILJ	LOUIS
A2HARL	AZHARI
MPLYMYEPKYKY0YVYYIYC4Y	MERKOVIC
WM	TOCH BEGRAM
HAIWFKH	MAIWENN
WUYER	ROUYER
B0HC0MPATN	BONCOMPAIN
Y1JAMLJ1	SAM
LMPLYKYWGYD40WUUYWVY	KEDDOU
WEINBERG	WEINBERG
HYPLYLYYAPY0YRVTYEYPYY	LAPORTE
WLEGEAYYL	LEGEAY
P1HARYH	MARIN
NEXLFEL1IE	DEMISELLE
FERLRY	FERRY
HA11LYWE	HAILYNE
MPP1YYLAYRY0PCWVHEPJVN	LAROCHE
1HMY1YLPULZEJJVFVI	LUZE
M1CI1A0NIVNAANTRU0WH	CAO VAN TRUONG
MY1YHPALNWWAVUVJ7L	HADDOU
LLY1LC1AFTJR0	CASTRO
P1AYHNDINE	AMANDINE
MIWRLFANWAHW	IRINA
XWGYERPYYYMVVYVL	AGNERAY
ZII1D15IIJNNM0ANQNM1NW	OGINA
C0DIH0VRSW	COUCHOURON
RIW1RD	RIBEIRO
VARTABEDIAN	VARTABEDIAN
EYUWMHE	EUSTACHE
WMUNNQWWYIYUUYY	GOUVENAUX
KM1FURAY	FORAY
Y1DELLPYHIAE1	DELPHINE
CLARA	CLARA
IDRJ5	IDRIS
HAH0TAUX	HANOTAUX
BFYARH	BOYARD
QM1MUSHLLI	MUSITELLI
AGH5H	AGHSH
1LZZMJN1Z	LEMOINE
HWHELJEHNEHHLH	HELENE
LEA	LEA
ELKRRBHS5	ELKARBASS
ZINANE	ZIDANE
ANY0YUFK	ANOUK
PLY0USSEF	YOUSSEF
JEHW	JEAN
LM1TH1BAULT	THIBAULT
AMWLBMLWNNM	ALBIN
LW1D0CVHGEGYYY	DOCHE
JEANWE	JEANNE
LWHHIHJAHL	NINA
MLHJLA	AJLA
H0MHAHLL	DONIA
JASPER	JASPER
IWNAYA	INAYA
H0SATTEL	HOSATTE
LAVRENT	LAURENT
FMAWC015YYYYYPY	FRANCOIS
KHGLHS	RAGEUS
TYHDMY	TOMY
BIYYJAHIH	BENJAMIN
GFEWIRE	GREGOIRE
CEWER	CETTIER
NM1HELYT5YSYAY7YY	NELISSA
WSPACYWYPHYVP0VWJA	SALMON
MPEIRIW	PEIRIN
IFLK0HUWT	ANTHONY
HATE0	MATEO
SANCHC7	SANCHEZ
TIIKHRKWHE	RIBARBACHE
LCM1GAYTAN	GAYTAN
IMLPLECYVGIWYELVLY	LECOGNE
LYATPMI0EH	LATIMIER
MLLDUI5	LOUIS
DWEL0BE7TYVPVLLNF	DECOBERT
CHILH	GHIN
H0RGANE	MORGANE
W1LRURA	LAURA
M1LUKAS	LUKAS
BELBACHPR	BELBACHIR
MM1MDMEFLVNHYVUYGQDK	DELAVY
EMMA	EMMA
AY7AU	RIZQ
CMMRREY	CHARRE
IM1LAUYRYYYC	LAURY
ALEXKNDRE	ALEXANDRE
VANHHREN	VAN HAREN
NWLLLEGYRVHYNYDYYYY	LEGRAND
CWWLHMWW	CLEO
5AM1IA	SAMIA
5AUTHQH	SAUTHON
JCLY	JOLY
MWALFNEQN0RHW	ALIENOR
LLWMIJW06NUNYST0QXL	AOUN
MARH	DUARTE
LVCH5	LUCAS
2JMHSSE	DAMASSE
JFPLHE1KESCHULZ	FILERE SCHULZ
BWELABRE5VLPLLJVY	BELABBES
XMIWGUEF0VUD4AYYSYUUEIY	KINGUE MOUAIIGUE
FANLLL	DANIEL
MWIW	NONIN
LM6LJIANIAJAHHLHLHH	LINE
KKEJVIEWHW	STEVEN
EN0RA	ENORA
MLN0UY5YFYLYYP	MOUSFL
MW1YTMALMV0INJLY7YN	JAMON
WWEMHKAWNW	EMMA
EWMKMNAGHW	EMMA
IHALAYE	CHALAYE
FNW1IFUYRBFAVVY6IYTIVA	FOURBAULT
MMLCHELVGFJIIVJ	MICHEL
ALPMQN011SL	AMBROISE
R0HW	ROMEA
DH0RGES	DORGES
LEHAREC	LE SERREC
G1FRRWCYE	FRANCE
PLAATHL1S	MATHIS
LM1PIERRE	PIERRE
5TANL5LH5	STANISLAS
LWJE	LEONIE
BUFFET	BUFFET
REMI	REMI
BRENAUD	BREMAUD
EWWM1KLWIFNW	EMILIE
FIMLL0UNANNE	LOU-ANNE
MMLALGLJEP	ALIJE
EPINL6AIIKF	ESTEBAN
YM1HMIUUZPJGVYY0Y	LAUNRAY
IWYLJY0YUYBLEYLIE7TWGF	SOUBELET
MWET	MIGNET
Y6CHXJI2EN	CAMILLE
LW1HJGLJQMIJ1A0RHHJ	FAGRECE
M1LW	LEO
NJIPMW	TRISTAN
M1HLHLS	ALEXIS
PPLYPYSGZY0PWLAKYYY	PSONAK
MYLYLMEIUYBJAIYNPIT	LEUBA
MPLYYPEYYFRPPINYYYPI	PERRIN
WLHAUERSPXRGER	HAUERSPERGER
P1CASSAHQRZ	CASSANDRE
HAUTINS	MATRIUS
1M1FHWW	FANNY
DWAHW1A	DAHLIA
G10RDAN0	GIORDANO
M1M0M	MIMOUN
ADRICN	ADRIEN
BDUDT	BOUDET
IMYPY1YPYYMVILVRVAVVWV	PRAIRA
MLHATHAN	NATHAN
HWQMEP	GEORGE
NMLLYAYYIAIVKVAPHLVY	YAYILKAN
MFMAKM1W0AW	PABLO
3MZZBAU	BEZEAO
MLHAM7A	HAMZA
M1BEREHGERE	BERENEGERE
P1CLELIF	CLELIE
MATHIS	MATHIS
Y1DELAVALLE	DELAVALLE
LDBEKT	LOBERT
MW1MWDLLUYTVJVVYYY6	DIOT
RMPEBY0YULYYVVYVV4U	REBOUL
Y1N0ENFE	NOEMIE
MENU	MENU
MRAPPYYPLPVYN	RAPP
M4HRTEBJ5EYGYFYYY	HURTEBISE
LWDJAMJIWJJL	DAMIEN
CVBZLEK	CUBLIER
H0XGANE	MORGANE
LJT1I	NOM
TLWJHWJHHHHHLL	THEO
MCREAU	MOREAU
CHL0E	CHLOE
MJCLWPHH	CLEOPHAS
MPAW1JACQVE5	PAUL-JACQUES
G6LI5A	LISA
LEWHLLJIJCTJLH	ELLOIT
LP1LUWE	LUCIE
JWWADHEWNW	JADE
AJMNWJHJHNAHHH	ANGELINA
ELTER	ELTER
GU3Y	HUGO
HYHMAR	LAHMAR
PWECMMVVIYYIG	PECHARD
BENIA1X	BENDAIX
WR6NEF	CHARLOTTE
3NLMHS0	OALMASSO
LY6LMLIEJK	LAGIER
AM151LGESY	GILES
NM1T0HYA3YLYGYFY	TOMASINI
CARCVA	GARCIA
CM1NL1WIEAYUHE	JOUSSEAUME
M1LN	MILA
RCKECS1AHHETTE	ROGERS-ANNETTE
LY1BVWYEMY1L	BOUDJEMAI
M1UAIRE	CLAIRE
NMLBERY6NY	BERGOT
LYLMQGE	MOGE
C0RBJ1ER	CORBIER
WL	AUGUSTIN
Y1FJE1LRRIJE	FERRE
WWTHJNWAYNW	THOMAS
ABHPJMHCPMSAYC	ABDEL REHEEMSAYE
MLXJ	EMACK
MHEL1E	MAELLE
MYLYPYRL0VJVVWVVCE7YT	PROVENCE
ALGIYIL50N	ALLISON
LLY1PITAULT	PITAULT
Y1JDHPS	JONAS
P1C3AHIB	OSAMA
WW1YPCYLVLVJQJCAYL0VNJA	GRIGORION
MLAYMHIC	AYMERIC
MP1YFYAYYUDYEIUUKIVH1	FAUDEUX
SFLLDV	SILLOU
B1APTIITE	BAPTISTE
F1FEN5AM1N	BENSAMIN
IYWSWRE	ISAURE
M1GARDNCE	GARANCE
AMWLIAYWANDREAW	ALEXANDRE
FWLMANUEL	MANUEL
CWHLH	CHLOE
LM1EDWARD	EDOUARD
LY1S0N	LISON
PIGXW	PISTIEN
JLHQUAH	TITOUAN
M1BELIWDA	BELINDA
JPCQUEMIN	JACQUEMIN
LAUNHE	LAURINE
AMWJTNVNW1NENW	ANTOINE
HWWLL1KCW1LLHNW	ALICIA
IP1NE11YGWANP	MEIGNAN
6AZLLE	GAELLE
CLEMEHT	CLEMENT
5ERRC	SERRE
LP1JUWINE	JUSTINE
IYLR0YHHE	ROXANE
MLWEAMWNM	LEA
JSAH	ISAAC
SHAHEL	SHANEL
FLAME1L	FLAMELL
W1YHIWXEYE	PHILOMENE
MLGI0VAHHI	GIOVANNI
Y1RAEKYELBC0M	RAEKELBOOM
BCEDEWH	BORDERON
HMHITAEDAW	MATTEO
LP1I3NUREL	ISAURE
MLLSHNTIN	CORENTIN
YLTHFBAUT	THIBAUT
0CEHWE	OCEANE
M1JULIE	JULIE
SWWARGAWHM	SARAH
CELINE	CELINE
LMILQYA	TYA
TH0YAS	THOMAS
REIMACL70	REI PLACIDO
P1RALTHU5	BALTHUS
HIJEZ	GUEZ
JMWADNEWNM	JADE
RA08QVLN	ROBQUIN
LM14BGYIEGNLAYWYSYKGIGY	BIELAWSKI
Y1EXHALLLLLLHLJ	EMMA
SYCJKS	LUCAS
DECAUNE5	DECAUNES
MATHIE	MATHIEU
KADL50N	MADISON
VJCTDR	VICTOR
MPLYPYELVQD7RJNE7AUYUV	PERDREAU
MW1YDMULFYATLV7JJTN	DUFAL
LP6HALKLWH	MARINA
BMEKMA0UL	DRENOM
WUYADS	HOUMADI
YL1LILAUZADEHHWLW	CLAUZADE
RNMM	ADAM
CYR1ELLE	CYRIELLE
P1CHLW	CHLOE
K0MATN	ROMAIN
RAP0LD	RAPOLD
WDYYEGWYY7ELYIGIYYPYVY	DENZEL
LHWJ0HJAJHEDHALHLLH	MOHAMED ALI
W6WYHYYCGWVVKSK	ROCHE DUCHESUE
RAQHALJL	RAPHAEL
M1NAELYS	MAELYS
THIBHVZT	THIBAULT
0M1YRYKZL5DY0YYNK	YAMKILSDONK
LMLJULFPN	JULIAN
M6MAXEWCE	MAXENCE
M1J0FPANE	SOFIANE
M1AHNAUD	ARNAUD
KARJLIWA	KAROLINA
MM1YLWEICVEYPYLLITVAJ0THNE	LECAPITAINE
B0UCHP4	BOUCRET
MYYADYS0N	MADYSON
DGJW1L1CELLIHNNANN1NM11IM	CELINA
QWFCXWVVTYVWYI	RICHARD
P1CLLEMENCE	CLEMENCE
M5R0IGYYYGYV	ROIG
TIPHNINE	TIPHAINE
ADLEHE	ADLENE
HAY	HAY
U0LLEC5	VOLDERS
LMJLEWAYC	LENATC
WL3H1LWE	NISRINE
YILD1Z	YILDIZ
QM1DEBARN0T	DEBARNOT
LPHV	LEA
MP1YJPALVWUVYVVV7N	JANYY
Y1BLAPTTSTE	BAPTISTE
YL1LEHLA1IHH	CENA
FERRANDAGEISLER	FERRAND-GEISLER
NATNAH	NATHAN
P1MAH0H	MANON
THCHAS	THOMAS
H1L1RLQIB111JWNLNMIW	ROBIN
AMBDALLAHYYLYYGYY	ABDALLAH
MLVAITIARE	VAITIARE
HERY	HERY
M	YANN
BLMWU	BLOMBOU
P1RENAUD	RENAUD
KMETM5YYYGYYV	PIETERS
WWLMQWMJDU7GIW05TFP	NOM
LYS1LHCB	CHBILHEB
RMPYMYEYLYV7IUTVJN	RAVEL
Y1LELLILE1LII	ELIE
NM1G0UPJL	GOUPIL
RI0	RIO
AMELIE	AMELIE
DYLANH	DYLANN
DJEIA6RAN6E	DELAGRANGE
MW1MWDEYLUPYYJJIQYRJK7Y	DELPIERRE
P1EHEL1WE	EMELINE
Y1I7LKKHHER	ISKANDER
SLACHA	SACHA
EVAW	EVAN
M5DERIAN	DERIAN
GERYMW	GERMAIN
WWET	MOUTET
M1ERWANX	ERWANN
WWLJ5E	LALISE
DEPQNTHAUD	DEPONTHAUD
MWWHFAW	FRANCOIS
HYIVH1ET	HIOLET
WMAHUJA	BHANUJA
M1ANAELLE	ANAELLE
AWE	AGATHE
LPB0NJE	LEONIE
P1FIELRLCK	DIERRICK
HLE1NNDRE	ALEXANDRE
JWLJUCJIJEHHH	JULIE
WMI5KNTWELINWJ	ISMAEL
AHLIS5A	ANISSA
LEANE	LEANE
PPHULINE	PAULINE
WHELLEUX	RELLEUX
H0VHANNLI3YAH	HOVHANNISYAN
J6LIVEAU	JOLIVEAU
LH0NME	LHOMME
LAMBZRT	LAMBERT
FWLLCHAYHMHNH1NM1LM	CHAYMA
JWWLYPWI1CVH6AJV4APNVTYIZ	PICHAVANT
P1NEL0D11E	MELODIE
DEPLACE	DE PLACE
P0YRTER	POIRIER
MWMUPREIW5U0KUUYZL	FOURES
M1AUGIER	AUGIER
VFN	UGO
BMPARYDYIWYETV0PVVJH	BARDINET
SAT0RA	SATORA
P0UP1LH	POUPIN
CWRIN0H	CRINON
0FHEKU	OPHE
MLLLELAALJ0LHLH	LEA
WAWNNNWIHENW	ANTOINE
TULIER	TELLIER
HBDALLFHMLUQUET	ABOALLAN-LUCUET
NAU0DW	NAUDON
L0AHE	LOANE
WAMRHH0QHW	ARNO
W1EIJL1R	GEISLER
MLQAUVEHIL1	MAUVE
PAPMME	AMBRE
Y1LPLLMHIRAIHCJKL	PIERRICK
YLLAHHJ0FL1	SAMUEL
M1HMHY	AYMAN
M1LLARH	CLARA
TMPHEYZYEYVLYJIUUV	THEZE
M1BAIAIML	BAPTISTE
JM1AWWREVMWGI	ANDREMONT
5MUNDHRALHLNVVGPVMVVYI	SUNDARAZINGAM
CHNFDDKLR	CHARLOTTE
MIAUTECLGE	AURELIE
LY1DIJEAGHIY	DURAGHI
CLARA	CLARA
KYDYQUAM	REDOUANE
MAN0N	MANON
LMW6MWHLNW137DJJUYU	SADIQ
HARGAUX	MARGAUX
MTRAJAP0YNIYAPY	RAJAONIA
TALHHHRI	TALAHARI
LG1NAXINE	MAXIME
M1MARIELIZSSE	MARIE LIESSE
AWMP0NLWL1KNW	APOLLINE
MHCFN	MACEO
ETJENNE	ETIENNE
G0IGE	GOUGE
F0USJARH	FOUSSARO
MWLAMK7WL1EAM	CAMILLE
R1G0PD	RIGORD
MHM	TRANCHAND
FL0RIIN	FLORIAN
HZ0FAI	MEDFAI
BMRUYANTGGYY	BRUIANT
J1ALARICLJH	ALARIC
GIRARDIDEVMS0N	GIRARD DE VASSON
MMMHAHW1LWHW	MATHILDE
BCICE	BCICE
FL1CIYPLZLE1RE5	CYPIERES
NDRANT1IH	MORANTIN
MMW	ALBAN
B0ULHER	BOUCHER
THE0	THEO
JWMEANNWNENW	JEANNE
HNJNIIHA	NORELHIA
WHLLL5HH	NILS
F0LIZH	FOLLIN
ABEILLARD	ABEILLARD
HA0UEVAN	LAOUEVAN
D0H1NGUEZ	DOMINGUEZ
W6TKWDC	THOMAS
DH1JARD	DRIJARD
FMPLYHYE1VRRPYJLVJNL	HERRY
RVEV0W	REVON
ZLP1LNLPAUNRQANNNKNWIM	LAURA
MP1YYBFYRRPVAYYY4YY	BARRAY
5CKMW	JORDAN
GPMWKLE	ANGELE
Y1IWLLLLKAJ	VAILLANT
TY0LZA	TOLZA
MLCALURI	CALURI
YLLDKHIYLTAHHLLHHL	KILIAN
NDA	NOA
Y1CERIHE	CERINE
H0NAHC	ROMANE
GMIILBAUD	GOILBAUD
MTEMMB	EMMA
M1LCQRRAINE	LORRAINE
FLURIAW	FLORIAN
MLRHWU	WALRAND
QM15IYM0YHYYYLV	SIMON
MW1MWNNFLTQ4KFYLYDLY1	BOIRE
NATINE	MAXINE
JA50N	JASON
LAURH	LAURA
G1LPETYIFTPYYY	PETIT
AKTHUK	ARTHUR
CYYLAM	CLARA
VICT0R	VICTOR
CDRBIERE	CORBIERE
JMTDELASSUGSYY	DELASSSUS
BL0UET	BLOUET
ZCE	ZOE
IM1IELYYWYAX71ILPIT	EL OUAKILI
LY1WLYUHL	WINUM
NYHHE0	MATTEO
P1THE0D0RA	THEODORA
5AXM	SAYAH
GPASYPHRD	GASPARD
30VI1RIY	BOUVERET
SK6HS0PERE7	SACAS-PEREZ
JWUERYIYYYYYYPY	JUERY
LAHDREAU	LANDREAU
VEJUX	VEJUX
EWLSR	ELSA
TYEMH5	THOMAS
GFUNLK	ELANIE
TWALANZSC	TALANTSI
AR6UEL	ARGUEL
MLMATTHIEV	MATTHIEU
MYJYNYAYJVINHKJZ1YHJI	WAGNER
SAWUWT	JACOULOT
YLEHN	LINGOT
M1LWLV1NE	LUDIVINE
M1LFY03VSLAPTPIYLWY	FOSSATI
MLLILDU	LILOU
B1LJ	LUCAS
LW1EHCNC6	CLEMENCE
K0GUES	NOGUES
B1LYNE	LYNE
MLSLXT1NE	SIXTINE
DEKHUYDT	DEKNUYDT
WMCA0QUET	DULROQUET
BYEATXWD	BERTHOOD
BW0UCHEREYAVUYVYYYY	BOUCHEREAU
GU1LLAVME	GULLAUME
P1CLARA	CLARA
Y1MYAYN	RONAIN
Y1AHYHYIKHRHICHI1LHLH	AYMERIC
HSWAERJVAAWNHW	SERVANN
PAUH	PAUL
BMRA55EINVJJLTUGYII	BRASSEIM
LMPP1YCYRYEVTLLLNY0LNYAV	CRETINON
LM11B11VLLL00FWPYYY	BILLON
MDEU0UHYYPYFPY	DELCOURT
GWYRD	GODARD
LY1LWLISIL	LOUIS
HAXLXE	MAXIME
Y1FUA	EVA
M1CLARA	CLARA
HLYAH	KELYAN
CAHILLE	CAMILLE
MLMWIS	YANIS
Y1VIFLKHTA0IRI7LWIEHHJ	VICTORINE
DYPRIBEL	DORIBE
3YAHAL1	SAHALI
JUL1E	JULIE
MLL0ULS	LOUIS
P1M1KA	MIKA
WMWLKLWWNM	COLINE
WNBLENY	DOBIGNY
YMIDALYYYYIYY	VIDAL
J1CELMLH	CELINA
AM1I4YY0YLUVYHT4AVRYHY0	VOLUNTARIO
YEHET	PENET
FL0R11WE	FLORINE
NM1F0WT0WLCZ	FONTOWICZ
LLMJH1RIY1H1LAHHIW	RIH
DELT0UR	DELTOUR
M1DUSAYRTPL	DUSART
M1YVIYLLYIY1EREPY	VILLIERE
TMWPMGWINPW	TPORINE
MPMPCYAYFYYPVI4VVVNY	PACARY
FYPVA	EVA
HJN0	NINO
FWMLMJUJUU7GF	CAMUF
ZELIE	ZEIZE
W1EENAKFAN0YNE	BENAFA MOYNE
MWAY0NVWDNM	AYOUB
WLF0UX1DRYGWYEZ	FOUKDRIGNIEZ
HM1LHH	LANA
NM1CAMVAIARAYPVYG	CAMARA
L0RI5	LORIS
HFESTRHCC1	MAESTRACCI
MM1M1WIJVBYDCUXLZ0H	LEBAS
CA1MEL5	CALMELS
MINLIE	JULIE
PLHUEDEY	PIQUEREY
IM1IFRAYDPYIHYYYGYF	FRADIN
AWMWMQNW	ALEXIAN
NW1LEVFAYUVCHEULXLY	LEFAUCHEUX
F1LEUR	FLEUR
MHHNA1HN	BONNEMAISON
MAUREL	MAUREL
MWAGUYILLY0XVJLNYUWJ	AGUILON
MCAUD	PACAUD
LY1VANH0YUTTE	VANHOUTTE
CMHAVVEL	CHAUVEL
II1C1	SJIEP
FMGPIYMYYL1CYHJEYLIY1YV	MICHEL
GLWJE0JFHFRHEYHLJ	GEOFFREY
NW16ALYIYMY0NTYVY	GALAMONT
ELSA	ELSA
HHDEF	HADEF
AK41AINHW	POHAN
AMWDANMWNW	ADAM
YYP1YYYYULVLTUDWATVVV	MOLTON
MWICHAL	MCHAL
WMLMCWNLC0ZCYH32Y	SASSI
YHAL11PRF	HALIPRE
HUW	TOUZET
GAB1ILLAT	GABILLAT
MY1KWHLNUNYDUFZFJHUV	MONOPIFE
HDLHEQ	MAIHEO
FLWJLDJRJENTHLH	FLORENT
LN1H1	SABRY
Y1R0MAIW	ROMAIN
F0WS	FONS
HWLDAUNGHH	LOU
GREE011RE	GREGOIRE
WMSSRTYPY	GOSSET
5EFHCUR	SEGHOUR
FWM	FLORA
VARTY	VARTY
LMERME	LERALE
P1YAWIHE	YASMINE
5EDIF0	SEDIFO
TART1NS	MARTINS
GWILBERF	GUILBERT
EWWWNWW	ENZO
FELIFX	FELIX
M1LWRYMGWUI2YPYH	BERNARA
IW0AAXE	ROMANE
Y1GPY0UJL	GERAUD
5AYM	SAIM
CCLINE	COLINE
CMWYNKTWHIANW	CYNTHIA
SRIVWU	GRIVEAU
LML1E0	LEO
MLCELJA	CELIA
LEGHLL1	LE SAIIT
L0UJ5	LOUIS
BDTREL	BOTREL
AHYEET	ANEET
GASSAHA	GASSAMA
BNULILLETTE	BOUILLETTE
LAMV5	CAMUS
MW1MWLALUVYVYCXHP	DAVY
M1LAUMNE	LAURINE
MMWVRLSWENM	LOUISE
MMLMBW0IUWRJV5UFIUY5	BOURSE
QVENTIN	QUENTIN
EPLIYAS	ELIAS
KEHYH0LVEC	REMY HOLVEC
PJARMMD	ARMAND
LH1YT0UYMLAIIYYVY	TOUMA
AYMJC	AYMERIC
MWSATNIWWENM	SATINE
YDRGANE	MORGANE
NUREXN	MORGAN
AEHTHE	AGATHE
CARLA	CARLA
MMWMAIAWF	MANON
ZJT1A	SOFIA
MLPH0YHTYAYWPYEYVY	HONTAGNE
MI5M	TASHA
M1MAK0N	MANON
WMHH0ULIVJILUJG0	KAHHOULI
IY1DUYVALYY	DUVAL
KAHINA	HANNA
XL0U	LOU
WM0MHEAVX	DEMONCHEAUX
CAUDICE	CANDICE
Y1FRYY0YVAHYYYY	ROY
DEST0UCHE5	DESTOUCHES
H1FLLET	HILLET
HYJYHYAIYREPUHVTVJPU	HARENT
LDMLR0QUES	ROQUES
MGLYSYYYWYLDPPVVLL	SYNOLD
RWAU	REAL
HAEIE	HAESE
M1CELI1AL	CELIA
LY1CASSANWRE	CASSANDRE
TLLWNT	TILMANT
TYHWEN0UX	THEVENOUX
TIRANE	TIRANE
W5MAURYHE	MAURYNE
MLVIVH0HS	VIVOS
LHMJAUJ2HHHHJ	MAUD
KEZPMHS5ATY	KEIPMUSSOTT
RAHW	RAHHOONI
Y1MAR7EL	MARIE
LYNA	LYNA
AM1PTHY0PRIYYYY4F	THOR
NM1IEYLANJ	CEYLAN
IW1PPLEYRXYEYJTJPA	PIERRET
G0YEAU	GOYEAU
EVYM	EVAN
BHRHABE	BARNABE
HRWEN	ARWEN
MWWLMWDFNNAW	MAIWENN
BMELABBE5Y	BELABBES
EGWYMA	EMMA
UEAL	ZOE
HWWMNWHNW	SARAH
WLHTHNHJ	BIENNE
VALLEE	VALLEE
L0UJJ	LOUIS
GFETAN	GAETAN
31RTUMJ0M	BRANDON
GILLES	GILLES
MLMANFL	MANEL
YLBHIENRZW	BERMEJO
NLZCREL	MICHEL
MAHH0XI	MANNONI
AMLBERT0	ALBERTO
LUUWA	LOUNA
MTERKI	TERKI
IWP1YCYW1VJVAYTYYYI	COUJATY
MM1MWNFJUDILSDHWNIZYH	BERLANDE
FM0RETYYYYYYYY	FORET
GAYULIQ	GIULIA
6LHSX	CLARA
M1BLEYHARKATE	BENHARKATE
MW1MHWHLTU13YRFY4PTUUDIL	GUTIBERT
LY110LSL0LI	LOLSON
CYAPA0	CAPAO
PWX	POUX
SATIHF	BATIME
LAHUTTE	LANOTTE
AUDREY	AUDREY
ALICE	ALICE
ALIZEE	ALIZEE
WWLYBWELVRTDHY0VUGNL6	BERTHOU
D0UILLET	DOUILLET
MMLYWFCIVVCIILJLTE0YPJ	FOUILLE
FLYAH	YAN
H0SNI	HOSNI
HWWIE	NOEMIE
MWAXTNHWENM	AMINE
BRUYIRI	BRUYERE
LMM1R0YH5YARYDYVYY	RONSARD
MLJULIE	JULIE
MHWE	CANONNE
MYY1RYAYYYEPYRV7PNN	RAYER
YLMARLLE	MARIE
HMWARALAEHW	HARIE
M6SHKJ	SAMI
SWWHAHNWEEWNW	SHARLEEN
REYY	REMY
Y1NAMYAG0YUIY	NAMAOUI
MAM1	ADAMI
YD0N5	PONS
MMCSINAJRNW	OSCAR
M1YLYLYEYBVEPSLIH0TNVDVDLEC0ATPW	LEBESCONDDECOATPON
CMUMQU1FEREYYWYFYVY	GUAQUIERE
MW1MCWHL0UYBVLENTDMQY	CHOBLET
RWYHYYYYY	ROTH
M1DYLAN	DYLAN
CVGNET	CUGNET
PLELIP	ELIO
WWEUNKAWNW	LUNA
G1ALBAH	ALBAN
CILIMULI	COLOMBE
ZLI11ILDHZNA0RIEN0UWLM	LAZARE
S0PHZE	SOPHIE
U2LYYER	OLIVIER
LY0INTF	LOINTE
WU	LOU
WM1MHWCLV0NTH8N3Y3YF	HEYMAN
FAURE	FAURE
YJMYWS1	MAYLIS
DMALMA550YVGYPYG	DALMASSO
1HCFLL1PZIL1	NOAL-JAME
PICARD	PICARD
YLAL1CIA	ALICIA
MEEMAISGY	GERVAIS
EKITAC	ENZO
DELALANDE	DELALANDE
CM0NANVVVVTJJ7	CONAN
EPPSMA	ESMA
EYYA	EMMA
MAYA	MAYA
Y1AXLEELL	AXEL
AMLBERIICJYNLPYPIL	ALBERICI
UARA	CLARA
Y1EREYSIPP0YPYY	CRESPO
M1MUL1NE	PAULINE
MLTEWHYZDPY	RENARD
KMWYLKIW8ANW	KYLIAN
M1IYHHH	DONNI  LAURA
CWEIUT	COQUEIUT
MP1YYHVLVCHJEVGTVTVN	HUCHET
Y1CHR7STIAHE	CHRISTINE
CNCILEK	CROIZER
TAL0B	JACOB
Y1MAXIME	MAXIME
ZNJ11	LOVIO
MMLYRWA14VW0AVVUDVNPN	RAYNAUD
GUEHAM	GUERARD
XJLLYAH	KILLYAN
W5ANANDIWE	AMANDINE
JULIENE	JULIETTE
MLY0RGAWE	MORGANE
NHTL5	MATHYS
M1ARNAU0	ARNAUD
SP0M0NI	SPONTONI
MPLYGYUYV1IBLALIELWMEIRLV	GUILLEMER
WMPMY1WYEWIQIIYI	LAMINE
LAWVETJN	LANQUETIN
LF1HLAHQT1ER	GRANOTIER
EVC	EVA
MP14FDPYECY0GUPRTYI4SIY	DECOURTIS
IJ1A1NNAMTIHTI7ANSNLNMLIM	MATHIAS
YLCUM31ARLEI1T	COMBARET
JWMAFAEWHH	JADE
TY0VRATIFR	TOURATIER
LLM1CREUS0T	CREUSOT
A6ATHE	AGATHE
AM1PWIYLVLVEVHIYYTVSG	GUILLENOIS
PETI0T	PETIOT
M1HAWCBA	MADJERA
M1CLAPRE	CLAIRE
MXMF	ROXANE
MMLEQNWHW	LEA
EMWL0MTLWMNW	ELOISE
CLEHEHLE	CLEMENCE
YTHAURHH	MAOREEN
SMWAKMLAHAHW	SAKINA
Y1LL0YJ5	CLOVIS
LAR0UHH6NE	LAROUMAGNE
WBIFHNAN	BRENDAN
M5AL0ME	SALOME
D0PPLER	DOPPLER
P1EANHZLQHIHINHHH	ENZO
5AKVEL	SAMUEL
UEANE	OCEANE
JINKNEZ	JIMENEZ
MPLYWP1YZNPYHYJYYVIL	MARTIN
JWWJLMEW5W	JULES
WJMADNEA0AXAELNLWE	JADE-ANAELLE
PR0V0ST	PROVOST
BHDU	BONDU
ALTUWA	ALTUNA
TMRZP8RHYVYYYLY	TREPART
LM1SCHY0YEPSYEYRVYW	SCHOESER
M1LUCA	LUCA
MYAS5E	MASSE
LWEJVRJJHLH	EVA
RMWVDWL0IWFFUYYYTY4L	RUDLOFF
LI5A	LISA
JWHR	JEDAR
AM1LLECPAYMYVVVV1	LE CAM
CKETAT	CRETAT
HTHRDVWFWI4W	PATARD
TDM	TOM
MNJHWMR	RANJAKUMAR
CDUTELL1EQ	COUTELLIER
AMYP1YFYYIV0RVFINVZVVAJY	FIORENZA
MW1MWLELTUUERJRVIJLJARH	LETERRICR
KYIN	KEVIN
HMY	AMY
H0RH	HORR
BAY1JIC	BATISTA
MFFLHIAL	MARISCAL
Y15AWCHYEZY	SANCHEZ
YERTILE	YERTILE
DM1WL1LWH	OBADI
FMACQUEURYVYYYYYY	FACQUEUR
C7R8JI5FER	CORBISIER
DCLDLICWE	DELDICQUE
AALA1W	ALAIN
DMWMI	DESFONDS
MPTYYCAPVLAVMYVELJVYN	CALAMEL
HZLANIC	MELANIE
D05JANT0S	DOS SANTOS
DERUDDER	DERUDDER
Y0UCEF	YOUCEF
TAN5UY	TANGUY
EHYYA	EMMA
MLWFWMWF11NW	LIGORI
RAPHAEL	RAPHAEL
DELACHAUX	DE LACHAUX
PERIG0IS	PERIGOIS
QLSS0UB	AISSOUB
M1HLENA	ALENA
LQA	LOLA
FI12HHAFTHHIZH5NQLNW1IW	MATHIS
MP1YPYLLEVH3YWPJIVN	PLESCY
ALEX1S	ALEXIS
M1TH0YAS	THOMAS
MAIHQS	MALLIS
MLCARLA	CARLA
DWPY0YWYNYAIYPWTVJJY0AJU	DONNAINT
HJATIHLLDEHH	MATHILDE
ALWHMLLRE	AMBRE
W1LULAS	NICOLAS
HY115L1NILAC	MIGINIAC
PIETH	PIETRI
JUPLIAX	JULIAN
CANILLE	CAMILLE
ANNA	ANNA
SIM0H	SIMON
CAGN0N	CAGNON
HMH1IDLYTEHW	HIPPOLYTE
ENMA	EMMA
MYLYHPALYHIYVJFJJT	VAHI
MY1YYPA1SV2YUJVFCTRDYJ	PASQUIER
JYAILLET	JAILLET
MP1YCPKLHYLIIVBVVYHYAFIHIWNT	SCHIERYBACHIMONT
DVB0IS	DUBOIS
MART1H	MARTIN
20UISE	LOUISE
W	LENA
GPAUD1LERE	PAUDIERE
IM1IRAFFYRYAYV4YF	RAFFRAY
WWFRMMWW	FRED
WWNA1	EMMA
MP1YYL0LVUTVJAHLDIPVL	LOUTAND
LHURYHE	LAURYNE
GQLLAWT	GILLANT
CHRIFT0PHER	CHISTOPHER
YLYER	LEA
DELU2HE	DELORME
HLDEH1E	NOEMIE
LPLMERRE	PIERRE
J0JEPH	JOSEPH
CYPLHRA	CLARA
PLJ0JHUA	JOSHUA
LYJINLELSI	INES
ELEA	ELEA
HHWU0A0AHW	HUGO
MMJ0LEAWUJWWYY	PADIOLEAU
MLS8I2R	SARAH
ENHH	EMMA
IMP1YPPLYVWUEWYMJ	PLUMECOQ
D0RLNE	DORINE
MAWDRMIWENNW	ADRIEN
FUCAS	LUCAS
MLJZRENY	JEREMY
CFPYEU1LLE	ORPHEVILLE
ANYMYEN	ANNWEN
EMDDYWEVPIVVYVL	EDWIGE
W1UIS	LOUIS
YF1VEFS	VEIS
HJWHVNJNAY0BGILH	IVANMOE
ALLI	ALI
8FCNCT	PERROT
2MAURA	LAURA
IY1WLIHLL	WION
JULJEN	JULIEN
JMLYFKLRHFE1YEYIVY	FARGEPE
YPIAM	PIARD
LWCAS	LUCAS
JM1IPIVFTYL7VYIV	PIAT
IMPLYDYWIYRYYVHYYTIGY	DUTRUGE
M1AL1CILA	ALICIA
W1MPTII5TE1G	BAPTISTE
TH0MAS	THOMAS
EPPVYAN	EVAN
AFFZLF	AFFILE
GUY0T	GUYOT
SPLM0W	SIMON
ESYPERABE1VIGNAV	ESPERABE VIGNAU
W1S0SUE	SOSUE
LEA	LEA
W1FLEUR	FLEUR
D0UASBIH	DOUASBIN
HWWLYWB00UYYLLJLL0YNNJ1	BOUILLON
RCLLE7I	ROLLERI
NM1PBEYSSIVNMVUHY	BESSA
JWULEJ	JULES
MLAURKXGWYPVYLIYY	LAURENGOT
Y1YVLTGEYYLYIYY	VITEL
MELIMA	MELINDA
WY1YKM1LVISTATYWYIN	KISSAY
PMPSE	ROSE
HM1YWPELTVLLTD1VS0UD1YVKWTLNI	PETIT-SOIENTINI
MY1YWYYYIIWJHJWLWVV	DUVET
MY1YMF0LUVQDUVCVTYPEAYNH	FOUQUETEAU
WWTIW	TUSTINE
FRDWAYR0L	ROUCAYROLL
ARCHER	ARCHER
FKXJAS	ALEXIS
ELLA	ELLA
CMIEMENTY1YYYLYL	CLEMENT
LY1RCCES	ROCES
IWLGR0UY5YSEAU	GROUSSEAU
JMLD1IDYWPYYIY	DION
IY1GHNLLT0	GANITO
KQWXLLM	DBAXIME
K0RRIHERLI	PORRI MERLI
M6ANLSS2	ANISSA
MH	ADAM
GMU1LLAUHEAU	GUILLAUMEAU
HLAN0N	MANON
P0UI4ET	POUIVET
MW1YGML1RV6WJDAH06AU6Y	GIRARDEAU
ALBANE	ALABNE
WMRRECYYY	TORREC
LMEMNYYGYY	LE JEAN
DPUARFN	DOUARIN
WVTY	JOLY
L0WIS1MH1NQQUC	LOUIS-DOMINIQUE
SMLWYYLPLAVPY	SIMOES
PAHL0	PABLO
HH0LLE	NICOLLE
LLMPLYAYYLV53JJANQUDYILUD	AISSAOUI
MATH1EU	MATHIEU
T1EAVNE	JEANNE
AWNU5	ARTHUS
MART11N	MARTIN
WFEYE	SEYE
Y1MSYMYY1GYPY	NASARRE
CMYHAYPYIHYMJAU2ZJUNEQLNF	CHAPIN-JAZUEL
PI0CM	PIOCHE
CHRIST0N	CHRISTON
NFTHAW	NATHAN
WLQ11B1L	RILAL
C0WSTAMYN	CONSTANTIN
P1IKUWRY0YYHYAYYV	FURDYNA
RWACHDI	RACHDI
MWLMM1I1WU0YWZWC436ELL	CANONNE
DUNAR1HAT	DUMARCHAT
Y1CLEMENCE	CLEMENCE
LUCLE	LUCIE
JEWWA	JENNA
BEHJAHJN	BENJAMIN
HMWUJRJAHW	LAURA
THED	THEO
3RAVD	BRAUD
R0YEM0HT	ROGEMONT
MPTYHEU	MATHEO
INE	INES
MVRA	LAURA
M1NAYAHA	MAYANA
MATHL1EU	MATHIEU
NY0IRET	NOIRET
LMMILLAIY5LNYGEY	LAISNE
KELE5	KALES
CHRJ5TLIANIAB07LIN	CHRISTIAN - BOTTIN
HXTHLS	MATHIS
WMYELYINYEPTTHVKIJLILUT	BELFETTAR
Y1AWT01HE	ANTOINE
MMWMHWYASNW	MATHIAS
JEBEHY	JEREMY
JMLAWYPHEYY	ACHAMLANE
M1MR6AUX	MARGAUX
CLEAWE	OCEANE
20ZIIN	ROBIN
JMDUYYYYYYII	JOUY
MBCLWVN	BOUKOUM
MLJEJYHCP	JEANNE
AMRZEFKIEWYIILPZ	QRZESKIEWICZ
WVWILIEMHTINWH	VALENTIN
SAUZHY	SAOZAY
HGAVLITH1FRHW	GAUTHIER
JJTHHH	JOSHUA
FFS1EH	FASIEN
ADELE	ADELE
M1J0NATHNH	JONATHAN
ZY1JV1S	ELOIS
HMM9RG3M0RYEM	MARJIRIE
MABILLKI	MABILLE
T1H0NAS	THOMAS
MLTH0MAS	THOMAS
JG0YR	IGOR
FL0NAWCE	FLORANCE
LIWHNEHJJLHJ1H	INES
L9LDU	LILOU
MWLY1CHAABTN	MOUTAABID
WE	MAXIME
LUCILKEL	LUCILLE
HYLYAH	KILYAN
SPP0PPHIE	SOPHIE
M1WLS	NILLS
BMQRBEYY	BARBEY
KUYRIELLE	EURIELLE
6EL1CLE	FELICIE
CYHHARL0TTE	CHARLOTTE
BWALADIERVJVVPJCP	BALADIER
MRR0D	PARROD
L1J1CIJLKQ0Q2V2L60D64VVMQY	LE GUILLOU
LEPAY	LEA
4HTRIET	THIRLED
YTBHKBLEUEJYVTEJK11A	BARBEDETTE
M1L0U1ANJ	LOU ANN
MM1MFWWIVNYYUTXTL	EWEN
JSTAS	JOSIAS
LHYYY1LHAYRWYYFERP	GARNIER
FFMW1MWFYLVKYNL7CAYJ0I	FERRAT
NWWAHHIWAHW	MARIA
UECHLDWH5	DE CALONNE
MWMMMWNW	HOAD
W1LTLCUL	LILOU
EM1VLIENNAUMA11	VIEAU
TMD	THEO
B0YER	BOYER
Y1ALBPIZYWLNI	ALBIZZATI
RYIKYHUPJ	RYNINE
LM6MKINE	MELINE
PLASSMT1	PLASSART
JWLJV6JILEHTTHEIH	JULIETTE
HRLA	KARLA
WSSELIN	GOSSELIN
HLIHE	HELINE
MWYYYCPLYEHYCWIYGCYPTJ	DE CLERCQ
LW1BI5TPEPUH	BISTEUR
YLLISE	LISE
MPREV05TYYAYJQII	PREVOST
MM1MHW0LVHTJJWYFLYU4V	HOHINAL
HAEVA	MAEVA
LH1AJULLFHHLHH	AUFFRET
M1ALHLS	ALEXIS
R05I1H	ROBIN
TY1JANL	TIJANI
AKMUUM	AKMOUM
HMLEAAAHW	LEA
JWYG1YTYYRAVBLULC6FL1Y	TRABUC
FHIH	PENIN
HVNLLD1JILCF	QUINTAVALLE
LY1KER0UXH	LEROUX
DWLSEVAW	SEVAN
0USLTELNWDT	OUSTELANDT
BEHED1CYE	BENEDICTE
WWADAKMWNW	ADAM
W1KTFRAV1	ESTEBAN
BPARRIDS	BARRIOS
LAURA	LAURA
HYFRULICRE	MARZELIERE
MLJYVIMQ1DDJ	MFFAMDOJ
JYAMN	JAMET
MW1YCWI0LWBYAJRCDU0TY	GIRARD
IJFQLNY	JERENT
5WYE0YLYEPUUQNUYVN	SCOLE
JYPVLJLE	JULIE
MPY1YPYYREVYY0ISVTYJIH	PREYOST
XU	XU
LMLMHELYJ	MAELYS
HEL0LSE	HELOISE
MEGHIT	MEGHIT
YVWLNCE1T	VINCENT
LM0THVFLYPYPY	LOTH
TC	TAO
Q5WCBANIEN	SEBASTIEN
MI0RLANE	ORLANE
LAWUCJAGSHW	LUCAS
SMERETYYY	SERET
APUSTRVY	AUSTRUY
M1LLEAHJL1I1HLH	LEA
LLJ6HM0UJ1ILIDCLLHL	MOULIC
MLAYKVT	AYKUT
MLJULIE	JULIE
LM1H1UGDL	HUGO
IM5	INES
WEWFW	QUENTIN
LMWAS1LWPGYVU	LOUASIL
MWUNEAUYPYYYV	BRUNEAU
M1JAU	JADE
YDRFLI	DRICI
SCAR7DY	SCARIOT
MTM2KKAELH	MIKKAELA
AXEL	AXEL
M1LDEVLNYIIYKVEWI	DELOZIERE
IMWRIKNWANM	IRINA
Y6EYWPIEVIML	EYQUEM
P1YT0DS5AHT0S	PINTODOSSANTOS
PBE0V35LRC	BEAUSSIRE
MARCHQND	MARCHAND
FWAUGERAS	FAUGERAS
MAELLF	MAELLE
RM0JAYY	ROSA
NDAH	NOAH
MAWDRMIWEWAW	ADRIEN
MWUDIN	GAUDIN
FLWJAHHIHLHHHLJ	FAHIM
LYEVA5T0IS	LEVASTOIS
M1DLIVIER	OLIVIER
MYILHEL	MICHEL
4LPEL0DY	MELODY
MWADH	AHADEI
MY1YWFULYLVLTHYYDUU	COLLET
ATULE5	JULES
LM1H0UKIDWHWFIW	AUDOUARD
CKPAY2LWTE	CHARLOTTE
CLEHENT	CLEMENT
AMWLEMXWI5AM	ALEXIS
M1HBKILKXX5HLLYRL	GABRIELLASHNEL
DESRUHAUXL	DESRUMAUX
RXEBI	AXEL
BEAVDR1ER	BEAUDRIER
HHIJAAMNNM	BENJAMIN
FFRTKT1V	PORTATIU
G0URL0W	GOURDON
JWYLYGYEPFYFURJDYVYY4L	GEFFROY
L0CATI	LOCATI
YYLYNPALDYA7LYVYM	NADAL
HHTHJLDE	MATHILDE
SWZERLHE	SUTZERLINE
WWI66EDEYYSYBYUYTYTYEYS	GUILLE DES BUTTES
MM1YBWEISVJTA012EYUH0Y	BESSAICH
B0TR0UX	BOIROUX
M1STMF	SIBRI
MYLYYREYGYYWYIEVYRY1YY	REGNIER
Y1CHL0E	CHLOE
VALENTHNE	VALENTINE
AXEL0	AXEL
MLMATHK0	MATHEO
MF0LLENFAYNNIYVYY	FOLLENFANT
ALEXANDRE	ALEXANDRE
WWWRK7WAYNM	DORIAN
LMPLYCYAYYLUL0HJAFTJYVY	CAILLAT
P1MNWA5	MATTHIAS
JBHTA	JABATTA
WAEYHAUDVJIYYY7	REYNAUD
AIAN	ALAN
WWIAYYYYNGYYY	BOUAFIA
DWEEPIKA	DEEPIKA
LAURLIHE	LAURINE
YLTHIBAULT	THIBAULT
M1MAXFMJ	MAXIME
RMYYKIYJFF5YSFVYYWYPV	REISASSE
TART1YEL	TARTIVEL
MWT0MN1WNW	TOM
NATE0	MATEO
PWEIHEXYAYYVYP	PEIFFER
A5PA5IE	ASPASIE
FY0UC0NWIEQ	FAUCONNIER
MLGNZ0	ENZO
KIVTHPHE	BAPTISTE
MY1YGPALPVP6YLNVVLDJN	GAPPINI
W1WYAHA	RAYANA
LYER0VX	LAROUX
P1R0NAN	RONAN
LHMH	LAURA
CWYAFYAYFPAY0VJJV0Y6F	CAFAFA
EMMDENNWHW	EDEN
YWLW	DUCLOS
TAIHW0H	FILLION
JULI1E	JULIE
LE0	LEO
LMW0UKIWSENW	LOUISE
CWVWR	GOUVREUR
M1I1JCLIEJM0ENNTDN0NMIJW	CLEMENT
M1BELDYTPTTY	BELOTTI
LW	LOU
Y1HAKTHA	MARTHA
LERAY	LERAY
NHTK0	MATEO
KM1EW	EON
MYHADLT	MINAULT
MLCLEMEWE	CLEMENCE
MATHLLUE	MATHILOE
IMP1YMYAYTVU0VVVYLCVVLI	MATOVIC
Z1L1EJWL1L0JAAIANMLNM	ENZO
M1CHARL1WE	CHARLINE
PIEME	PIERRE
I1ZIILJVJJQCAT7CJBCNJWL5M	VICTOR
WYUZENS	POUZENS
M6MLB10U	ABBOU
MM1C0UETTEY	COUETTE
DW1RIFFET	RIFFET
DANKUI	DANKOI
BENJANH	BENJAMIN
M1HAW0H	HANON
QUMTI1N	QUENTIN
P1WDE	NOE
HMWAMWNM	TEA
YMVEL	RAVEL
WMISSADFWYYYGY	OUISSADEN
LFWUCHFR	LE BOUCHER
LMY1YYT01NVKNEJTVGAIY	TONNET
Y1PI1CRLAELIEHNNWKL	PIERRE EMMANUEL
MNVVY	MAEVA
MWEHNMAWHW	EMMA
M1AVKL	AYEL
CMMMWQULWEHQHLS0JFSJJX	CROQUENOIS
S0PPYHIE	SOPHIE
KWYYINYDYEYRPSTUWTHYYDYW	KINDERSTUTH
T1ERKMY	JEREMY
LEA	LEA
BSLAL	BILAL
MYARAI5	MARAIS
MENIHI	MENIRI
LJMJULJIHEHNEHHLJ	JULIETTE
TRIETMAH	FRIETMAN
MWHSSL	FANTASSI
WWMHWWIEHW	CORLIE
M1WRYKYYYYIYY	BURKE
G1LMLA	LALLA
JEANNE	JEANNE
WWLEDMNMW	LEON
GALH3MZ	GALLONE
LHAHIWEY	CHAHINES
CCND0UM4	CONDOUMY
ERABLI	GRABLI
BERTHAWDLRUXLIT0	BERTRAND - RUBINO
CHLVEZ	CALVEZ
MLN0A	NOA
M1JEAN	JEAN
CHAFU1S	CHAPUIS
AMBUM1SPYYYG	ABECASSIS
BERG0UGNAN1RIS5IL	BERGOUGNAN-RISSEL
M1ANAELLE	ANAELLE
M1EMFLE	EMILE
BARTH	BARTH
WPEZ	LOPEZ
M1L0UFAWWE	LOU-ANNE
P1LENA	LENA
KERJEAH	KERJEAN
WR0UXEL	ROUXEL
DUCTQQ1	GORTARI
F0URICN	FOUEIEN
WWA	EMMA
M1PSZNLGAMW	DEL GAMBA
LG1I1TN7FHNWL7HNFNFNNM1NW	TIMOTHEE
AM1HFYHRIE	LEMARIE
AUSTRUY	AUSTRUY
M1IPAUYTYHFYLLVRUY	PAUTHPER
PYELIH	PELINI
AHT0INE	ANTOINE
SLIMI	SLIMI
PACQI	PACO
CLALETENT	CLEMENT
BAKT1STE	BARTISTE
JWMYLMEGCNM	JULES
MLH0EYIE	NOEMIE
NW5MAIQUAYIPRE	MAQUAIRE
MY1YDW0LVU0CEJTHJHVL	DOUCET
JMMULMIWENNM	JULIEN
HAYWHRJ	HAYWARD
6RENLER	GRENIER
M1ERWH	ERWAN
M1C0RNUEL	CORNVEL
IY1HPLE1TILTL1	PETIT
ALYCILN	ALYCIA
HLARJIDAW	LARIDAN
MW1YRW0LUVQLUVEHVYY	ROUQUE
WIEL	NIEL
KLEIN	KLEIN
KUYSLT	ROSSET
LLQW1EWEHLLCZYK	EWENCZYK
P1HAR1E	MARIE
MLYAN15	YANIS
M1WW	CHERAZADE
Y1NLE1HAJNLJ1LHIH	LEA
M5FERBECKQGY	FERBECK
LHWHHAARWLJTEHW	CHARLOTTE
GM10LFVYE11RA	OLIVEIRA
WHR1HFLIENW	CORALIE
IMYLYPHALRVUITJYVUVNJYIIAN	HARUTYUNYAN
LA6MLTHPP5	MATHIS
MGJWLEFVAUJFYJJUV	LEAU
NMFVAY	OLIVA
LQYC	LOIC
IY1GLAHLILYKLL	CAMIPPE
YIA1HIAIJWI5NAMINWDM	MATIS
IMWABMAKMTWJ7YHW	CABARET
HY	INES
S0PH1H	SOPHIE
ZAKYHE	LAPEYRE
MAELY5	MAELYS
Y1IBLAYLLLHHLE1	BAPTISTE
HA3S7N	HASSON
FMLARDVYVVVLW	PLARD
SACH	SACH
AVDINELLE	AUDINELLE
B0URDM	BOURDON
C0AMINE5	COROMINES
PLLUKH5	LUKAS
LE0P0LD	LEOPOLD
YLFHRRET	FARRET
0MHCWT	OMONT
AMNWEVIVVI4W	ANDRE
MP1YMYAIZY0TBYFEYRLPY	MAZOYER
HAYFLELA	MALELA
PEREZ	PEREZ
MLDRAYPPGEAU	DRAPEAU
ALEXANDKE	ALEXANDRE
WHLHCK	BOLLACK
HFMELLLH	HAMELIN
SML0N1LCYYY	SINIC
GMTLCYYINYTYEYGYYYIL	CINTE
AUBR1N	AUBRIOT
BWEYY	REMI
WMLUCHIGEHW	LUCIE
EWRWAH	ERWAN
CLARA	CLARA
W1KILLJAW	KILLIAN
LHNDA	LINDA
MM5AYWNY	BESANCON
LRWJAPJHHAELLHJ	RAPHAEL
ELYSE	EKYSE
MPETZ	METZ
MPPMIHE	MARINE
WANM	JOANNA
MMLPLEBYURUPPHPYJIY	LEBRUN
MMACHENAUD	MACHENAUD
NWWJTAHWE0HW	MATHEO
GRAGLIA	GRAGLIA
HYENNE5S0N	MENNESSON
LP6ALEXANDRE	ALEXANDRE
ENILTH	EMILIEN
HTW05HLJHHEHW	TOSCAME
LRULILHE	LAUILHE
LWP1YYANLVD7RETYHYY	ANDRE
MHRLNF	MARINE
M1YAWISL	YANIS
MY1YAYYUGVHPGLMNVEYPR0H	AUGAGNEUR
GVEWEE	GUENEE
Y1PDUYKAWVD1PVRYYDYST	DURAND-PROUST
MLKTRA	KEIRA
Y1IWAW	EWAN
WM1BHRI0HU10LL1L0N	BROUILLON
LLMU1Y33Y0HYYZY0TL04W1MNW	H
HYTYBYYELYAYAJBYIIYYPY	BELARBI
CI1GNA	CIGNA
WMWWW0NW	ROMEO
MLM0UANWANW	LOUNA
Y1ACLA1RLE	CLAIRE
KEVALWI5	LE VALLOIS
M1PAUL	PAUL
JAS0W	JASON
HMYJHYY0YEYPHVRIYWV0YVII	MOEHRING
JMWULNIWENW	JULIE
LAWUIENES	LASGUIGNES
EL0UAY	ELOVAN
WMWNWWNW	MORGAN
NATH1S	MATHIS
SYALLHA	SALIMA
LP1PACSME	PACOME
Y1CASTAGNE	CASTAGNE
YJBILKALIAL1	BILAL
GIL2U	GILLET
MLCAM1LLE	CAMILLE
GMPPFLY3YSSY0YVVYYLLN	GALASSO
P1NHATHHANLHLJHI	NATHAN
LW0U15LEJLJHLJ	LOUISE
Y1AGATHE	AGATHE
MY1YHYELVHIEVRYYJHVV	HEMERY
P1R0MAIN	ROMAIN
MARIN	MARIN
LUCZK0W	LUCZKOW
M1LILW	LILOU
TMCHH	ROCHET
AMWRYYYYYYYGY	AUBRY
YBYKNJKNIH	BENJAMIN
IMLLHERYYGYC	CHERY
ALIZEE	ALIZEE
AM1LFERYVMEYUVUYXYPY	FERMEAUX
AARH0VM	MARHOUM
YATE	YATE
LMHAGN0NPYYP	CHAGNON
JWWJLKL	JOZWICKI
ALEXIS	ALEXIS
WWWEKNWTFNNW	QUENTIN
MLYALEWTIHE	VALENTINE
AMWUIAWYHM	AUDE
HEPUTU	NEPOTU
AM1LEBDCUF	LEBOEUF
B0UFETT0VSSE	BOUFETOUSSE
WIW	MAELLE
DNMNGE	DOTTANGE
HMERVIER	HERVIER
MRDLF	TARDIE
2MWYSMPAAW	LISE
LWWLDUBRULLE	DUBRULE
MW1MHWELUSTJRJEZAJVYUP	MESTREAU
YFTINWN	TITOUAN
M1EYHJ	EMMA
ML1I1L0LL	LILOU
NLR1ANXE	MARIANNE
NM1VANHW1URMH	VANDEN TORREN
EILISA	ELISA
M1EHIAC	ENZO
NMHMA5G	NICOLAS
LALINE	LAINE
SARAX	SARAH
J1A1LVUHLNEIWT1NINHHENMIIW	VALENTINE
SE5URA	SEGURA
PLPIERR1IC	PIERRIE
WLEFHQN	ETHAN
4W1LECUPYGPYHVY	LECUPPRE
YDEHUYMK	DEMUYNCK
LPLAHY	AMY
CDRUJER	CORMIER
FLEXANDRE	ALEXANDRE
QUZNTIM	QUENTIN
WW1MNWL1JFULYQYUNHDYYU	OYYOEDDB
BHILLKUL	BAILLEUL
F0RE5TIER	FORESTIER
Y1BERNLARDYY	BERNARD
NMW0MRWANM	FLORA
MYWZL0M	MELODIE
GTERHK	GIERAK
LPLM	THOMAS
LAMRW	LAFARGUE
LUDIVIWE	LUDIVINE
HWH1DAAA	HAIDARA
AUGER	AUGER
CMAGNIARDYY	CAGNIARD
MY1YPEYVRYDJRV1LAVULJL	PERDRIAU
GARNIER	GARNIER
AMELIE	AMELIE
NAXINE	MAXIME
DEMAY	DEMAY
TMRUCH0T	TROUCHOT
9ELATTRE	BELATTRE
31YWLALHHLJ	MAIA
BRDCHU	BROCHU
PREU0T	PRENOT
Y1F0NTAINE	FONTAINE
LILEFEYRE	LEFEVRE
XMWDENHWNW	ADEM
MRMHMMWSHH	ANAIS
BRLDEL	BRIDEL
LHWL0UYYGAYHMYADPY	OUBAHMAD
3PNW	BINTA
PDIZERGVEI	POUZERGUES
MWANTYYFLYYYY	MENANT
LYL0U	LYLOU
WMLI5NHQHW	LISA
Y2KNM	YEANN
TMWKYENYYPYYYYG	TURKMEN
AIRTLHUKHH	ARTHUR
AXH	AXEL
HMWNKNYYLYYJPU	ASSOMREA
Y1LAVZE	LAVIE
YMLDWHJFUT0LYLUUY7YY1	DHEILLY
MRWAPKHWAELNW	RAPHAEL
LISA	LISA
WWHIIERVP	GOHIER
YEYEN	SEYEN
ASSIA	ASSIA
LYLT0LML	TOM
EMPCYYYYLPLEYVJPVVLYU	ECHILLEY
Y1LHEH0IHNILL	LEO
WYLLWE	BUILLAUME
AMAYP	AMAIA
WILLWNE	GUILLAUNE
CYHPL0E	CHLOE
AM1SAHYIZVTYPDHYIP	SAHLI
EME5	ENES
YF130YURRIAPGYUEY	BOURRIAGUE
APVLI2EE	ALIZEE
Y1ME8ILLJH	INES
AUM	ALANY
MFSSEAU	BOISSEAU
EWNZ0	ENZO
VIRUYHDTK	VIRUSHAIN
MY1YDYYEYYIYYYRIY6NJ0YVEYN	DE-YRIGOYEN
KMREBSYVTYYYIY	KREBS
KWMWI1DY54506R	BLANK
M6LE0	LEO
LMW1YHMRLWIH40JUUJ0LJ1DIJJN	GRENOUILLEAU
LAVIGWAVX	CAVIGNAUX
CILYA	CILYA
NEANE	OCEANE
WNET	BINET
LM1TVLKS	TULES
6A1ZLQA1Y1EC	GAUTHIER
FASTLE	BASILE
MWL0HMWWNM	LOHAN
R0DRLGUEZ	RODRIGUEZ
VMIAL	VIAL
MKHHU3TEFBW11Y	BELMOSTEFAQUI
LYDIA	LYDIA
BWWEWWHPILMHCWY6YYH	BENTALEB
P1PUEWTIW	QUENTIN
NARQNE	NAINE
CMAL1IE	CORALIE
M1PAUTFXTI	PAUTRAT
TAXDIAW	TANDIAN
AWUB0LNG	AUBOIN
Y1MLELL	NAEL
WIITCAS	PETITGAS
YL0WH	YLONA
M1CLALIRE	CLAIRE
L0ANWE	LOANNE
WM1YWRDJUMRHYUNJVK	BOURG
M1PLLY	ALAN
BL0HD	BLOND
0UCNK3D	OUCHABO
G1AKTAN	GAETAN
Y1CHW	CLARA
NAUYANN	STRAUMANN
PABL0	PABLO
FW1HDNTFV	SANJIV
D0RIAN	DORIAN
MTHHTEW	MATEO
HUGLHWF	AUGLANS
N1THNW	NATHAN
NAYA	MAYA
JEANNE	JEANNE
LEJEUNE	LE JEUNE
M11VHEMILNPH	VELAIN
GAUTRALT	GAUTRALT
WWWLNGWANW	JULIA
LYLBERAWARD	BERNARD
MAF0UF0U	AFOUF FOU
WMUTERVYYY	NOGUIER
M1ARTHUR	ARTHUR
NW1PIER0U	PIEROU
LEL	LEA
LYTPEM0LNL5AW	PEMONSANT
JULES	JULES
Y5MAR6AUX	MARGAUX
GRAHJQW	GRANSON
LALIE	LALIE
YANHT5	YANIS
CLEYCHT	CLEMENT
HATHFEU	MATHIEU
CAWRALF	CAPORALE
P1HG0LU	QUANG-LU
RYBINSKI	RYBINSKI
HPJHY	NOAH
LANGLHY1TLERDY	LANGLET -- LEROY
SMANGAREY	SANGARE
HATH1LDL	MATHILDE
IW1YCDCCYAPVEYLLY10	CACCAVELLI
WRM0NDADAZ	SERMONDADAZ
WMWUFTUPKEVMTVYYZV7	BOUTURE ADRTEN
VWHAMNJYQNAHW	VANYNA
TAPSWIER	TASQUIER
CHEV0IZLARD	CHEVILLARD
PLLE0	LEO
DEGENTLLE	DE GENTILE
Y1LAP0RTE0	LAPORTE
HZ70UNL	GHEAOUNI
MFMNC	APOUTTANNE
HILBERT	HILBERT
W1N1ILLJJ	JULES
LEFCVRE	LE FEURE
CMWLANRWF5HHW	CLARISSE
AXELLC	AXELLE
FMW1YWCH1VIRT0YLUY0IL	CHIROL
AWGU5TQ	AUGUSTO
MMLANNAWHW	LANA
HGEWDM	MENDES
P1FL0RA	FLORA
M1HFRIC	MARIE
PWHALN	POULAIN
STAHLSLAS	STANISLAS
Y1ALIXL	ALIX
RAPHHEK	RAPHAEL
JYFEHANE	JEHANE
IDAWA	IOANA
M6UYHIL	CYRIL
HWLDLJIWSHW	LOUIS
M1NATHAN	NATHAN
SAHLHEZ	SANCHEZ
RQHNN3Y	RENAULT
K0PEYHI5	NOEMIE
LWM0IMCWM	LOIC
ERNESTILNE	ERNESTINE
YLLGUIPYPYIVMYQIY	GUILLAUME
P1MWALUX1	MARGAUX
GWWUYNLQNLAVMEHW	GUILLAUME
AHEL	AHEL
TAXI1HE	MAXIME
CHI0E	CHLOE
IM1AUYHELUVYWVYEVRH	AUNEONIER
MPLYYF0IYRTIIJVWVVYV	FORTIN
WMWAHMW1MNW	NASSIM
AMEZI1ERI	MEZIERE
BEWARD	BENARD
HM0USNFPERVYIYPYPY	MOUSNIER
DW0KILAN	DORIAN
S0SEPHINE	JOSEPHINE
MY1YWLDLYPVIINXT7U0YU	LO PINTO
YLN0EMIE	NOEMIE
31L0LA	LOLA
DURUN	DURUPT
TERNACLE	TERNACLE
YYLYYR1LYDELT0VVPL	AIDET
PLHRTNYLR	ARTHUR
BWRKNELY	BRMNEL
PACL	PAUL
NM1YFLATAYRYDGYIP	FLATARD
MLHVRETVGVYLPPN	LAURET
M1MARIE	MARIE
LMWHMJAJINWHW	ROMAIN
MMWRNT0WNHW	MARION
CLEMENT	CLAMENT
M1ENZ0	ENZO
G1LLETYEYLLLYVIEYYRI	LETELLIER
GHHVIEH	GRAVIER
LY1P3PYRRP0Y1I5YYVP	BARROIS
MLHATHI5	MATHIS
YHLLLWIRA1HICNEA1HWIW	GARANCE
CAPRCAAN0LQ	CARCAGNOLO
MAZ0YER	MAZOYER
MWHUCIM0QNW	HUGO
HUM	HAWA
6MIGLEUXYYVLGYLP	GIGLEUX
DUFIERQQRE	DUTERTRE
YAWG4ELLUM	VANGQELUWE
AHBRE	AMBRE
P0RTER	PORTER
WLMATHI5	MATHIS
MMWWKWLINW	MAGALI
LYLJEREMY	JEREMY
M1LEMI5	LENAIG
BMAILLIEUXPVYY	BAILLIEUX
W1KN1VCN	BASTIEN
MWANHNWGNM	ANAYS
C0UWT	COUROT
LE0	LEO
PUJ2EL	POIREL
7LJRFAN	DORIAN
Y1BANYLYYHCULY	BAHLAOUI
AHJLADC	ANGLADE
LDEQ	LOEA
MXIMLIEW	MAXIMILIEN
C0JLLE1ATTE	COLLEATTE
LEGRAHD	LEGRAND
M1UHEWZC	LORENZO
HVAELLE	ANAELLE
HEBWD	THEBAUD
MY1YWPELVRTU4CHVJRTLUN	PERICART
MMGMIYYWIYGY	ALBERT
VFKH1HH6	CAMILLE
M1SEPH	JOSEPH
YLTR0U1LLARD	TROUILLARD
JLLAUHEW	LAUREN
MWYPWGYWYYVYJIJJYJ	DUPOOY
LMWUCMAWSAW	LUCAS
HPARYINE	MARINE
P1DYLANL	DYLAN
JUH20L	JUHEL
M1BLQC1HELIER	BACHELIER
W10MNA	ONANA
GUENARD	GUENARO
LP1ELIH	ELISE
FJ0NH	FIONA
HCHL1ACEHW	CHLOE
FW1CLEMEHT	CLEMENT
MPLY5PWLVHVYWY7Z	GUTH
BATI1LAT	BATILLAT
M1IL0RD	DLORD
DUHAUTUILLY	DO HAUT CILLY
MM1YWANLVCEINVAUYID4UL	ANCENAY
IM1AG0FYRY0GYYYY	AGOFROY
L1GLL1LAILEXIILFLLINW1IM	ALEXIS
L4L0U	LYLOU
MP1Y6YAPVRYNLJVERIVTL	GARNIER
NM1LAH0THEY	LAMOTHE
HEDJHKYJ	MEDJAHDI
E0RBIAC	CORBEAU
M1JBRA4YY	IBRAHIM
MMT0URP	DELTOUR
AM1PSHFYINYDYRYEYYWAYWYY	SAINDRENAN
MVJHYYY	VIREY
MLALVESP	ALVES
MWPHFAS	MATHIAS
JAHLER1DU3AY	JANIER-DUBRY
0SWRA	OSCAR
F0RNZS	FORNES
NMHX1ME	MAXIME
MLLE5TYQYREGLUYLVLYY	ESTREGUIL
W6EVANL	EVAN
YHNP5	YANIS
DJIMJ	DJIMY
9YLAW	DYLAN
MIANNA	ANNA
LAGEWTZL	LAGENTIL
WWKT	POYET
WMELIH5WENW	ELISE
TUH	TOM
DAR0N	DARON
MPLYIA	JULIA
KPQFDP	KOPP
5Y4V5XNC	CLAIRE
ALKEYRWHH	KEYRWAN
LFCLAS	COLAS
AMYS	ANAIS
LUNA	LONA
RYWNT0INE	ANTOINE
M1WERIHEN	NERIHEN
DE6XLZA1N	DE GAZZAIN
YWLHANN	YANN
1Y1EELVKY19DRUKHI	BRUEP - - DRULHE
LHL7	LILI
JMLWYIYYFFTY	ARBEZ
HAAH1UAELAHW	MANUELA
MLGHREHGH0RV	GREGORY
UMWPHKEWLLENM	OPHELIE
HYWALMHWJWEHW	YASMINE
YLPCAYRFAHYTHVHYY	CARFANTAN
ZML5UBLAS	SUBIAS
HDREY	MOREY
ELEDNDR	ELEONOR
M1RAFAEL	RAFAEL
LISA	LISA
MARWEH	MARWEN
Y1HNTH0NY	ANTHONY
M1CHHHAHLNUTJE	CHARLOTTE
IM1WYVKBEPYYIFL	BAYLE
HARTIH	MARTIN
PLFL0RPHE	FLORINE
MWLYWW0RYCVTHALWJDV0HUH	MARCHANDOU
AW1LS0UBYALBGYERYYE	SOUBABERE
B0URACHCT	BOURACHOT
FMUISLHIN0YGYYPY	GUISLAIN
YLWBLHJH	GABIN
MLWWVAH	DONOVAN
MC0UMELY	COUMEL
1YL1GUILLLAUMHEHWLK	GUILLAUME
DEH45F2AND	DE MASFRAND
MFPAUL	PAUL
YLYATHAH	NATHAN
NHW0ANJHJ	NOA
M1JWES	INES
FRAKC011S	FRANCOIS
1P1VLILCT10R1LHH	VICTOR
EPY0Y	LOU
GMWULMLWYKHNM	GUILHEM
CUWL5THWLE	CONSTANCE
WWCWZN0QHW	ENZO
EMEL	EMEL
MRM	BAROTTO
AILIMHDRF	ALEXANDRE
Y1PVANVWDIELHV0VSI5ELAER	VAN DE HOSSELAER
CSRLH	CERINE
ALJ5TAYR	ALISTAIR
FLEVRV	FLEURV
Y1T0M	TOM
TADC1L1DUFWUR	JADOT - DUFOUR
M1PRAT	PRAT
MVLD	DAVID
LWAJHEJXIHSHHJ	ALEXIS
M1GFHWK	HEATHER
GYWYANH	GIROMANAY
LETL0	LETLA
HED0LH	HEDOCH
HAKDE	MAROL
M1RABLUTL	RABIOT
TARRIEU	TARRIEU
M1YIJUL1IYAWI	GIULIANI
HARLHASD	MARCHAND
M1MARFUJ	MARIUS
ERNE5T	ERNEST
LMPLYBY0YYUI5GQUYYETYYY	BOUSQUET
MLVCEVLYYGY	LUCE
M0XHAWL	MORGANE
MATTE0	MATTEO
M2IS93NC	MAISSAME
ELBALHIKJM	ELBACHIRI
YMQLH0NGJIY7YPY	VLHORGUE
GRELLE	GAELLE
MW1YBWEFUANDAJGYDJUJN6H	BERNAGAUN
NARTINEKU	MARTINEAU
MMWTHHWE0W	MATHEO
MME55A0VDVLTIIPYYL	MESSAOUDI
AMHGAWUFYYY	AMDNEAU
0UKRID	OUKRID
YLR0MANE	ROMANE
MM1YLMHLLVYR07I1XJU4V	LACROIX
M1LLEVNTYE0YUYAFYHYIC	LE NEOUANIC
MMLG1UURD0N	GOURDON
EDUFRP	EDGARP
LWANDAI5YYLYTYP	LANDAIS
HEHVYV	MELVYN
YY1YYPE1RVNVHNUETGYYI	VERNHET
W1JEANARAPT15TE	JEAN-BAPTISTE
JL11VLALLIEGWNN1WI2NMLNM	VALENTIN
LMPP1YFBYY0WYNYHYYUVVVV	BONNEAU
L0PES	LOPES
WJWEAHVWNEW	JEANNE
Y1HLARGEH	MARIE
WJLW	NALAN
WL0U	LOU
B3ULAYVIRMAVN	BOULAY GIRMAUD
3PPUPKYE	BUKIE
MKHHYA	MEHAYA
JM1BLLHNL	BLANC
JULLLE	JULIE
Y1YPYY1CYQYUUVEYYQF	PICQUE
MMWAEMLWLENM	MAELLE
MWLMBWAIDVDIJWILIJJY	BADIN
CHL0E1	CHLOE
AMJST0YLYLYEYYRYYG	STOLLER
HY6MPAPRYTPYJVFVPG	MARTY
FWUHK	SAULE
P1CRR0L7HE	CAROLINE
NWVS	IANIS
MM1MMHTYPUJDISUDATDBM	LECIERG
CWELQA	CELIA
HKMHANHTH0WHW	KANTO
EHMA	EMMA
1YLXUL	XU
IM1PHADYIY0YHEYYYI	HADIONE
RUPPIW	RUPPIN
PADLICLEAU	PADIOLEAU
YYMEREWA	VERENA
MLL0RIS	LORIS
M15UBERB1E	SUBERBIE
AB1TWL	ABITBOL
FIGVERAJ	FIGUERAS
AW6VENHAJELHH	GUENAEL
MMRMM	CORMON
MAN0H	MANON
WUUMU	GONBAN
M	YAO
FWWLEJMWHCEHW	GLEMENCE
LM1LRHNE	LEANE
PYP1YMYYENVGMPYRYVYY	MENAGER
YMWQNKNWNMJ	YANN
Y1THE0HL	THEO
AM1B0UYRGESYYP	BOURGES
WML0WSIFUYEYYTIAWWH	OSSEYI-DOH
CL0K	CLOE
WBAPTLI5TE	BAPTISTE
MIAJHLF5HH	MATHIS
ETHAN	ETHAN
HQ9WLEQN	BOUVERET
GAL0PJN	GALOPIN
WMLYMALWVVWTENRUYWL	BOUVIER
CWWL0KTWL6NENW	CLOTILDE
AMLLM0RY0YWV4AVN0IY	MORDOGAN
HMIL1LY1YYALVYAKLALJIHN	NEIL NIMALARAJ
WCMLENMQEHCEHW	CLEMENCE
PMYP0WYMYPVUIYGJVY	POVEDA
MELANIIE	MELANIE
JWWEAMYWNEW	JEANNE
P1CECILIR	CECILIA
M1D0R11AH	DORIAN
RLL1IALRE	ALLILAIRE
NCMMMMRAH	MOHAMMEDAKRAM
YL1L1V0IIL0NLVET0MTENM1IW	VIOLETTE
M1HATHHN	NATHAN
WGLC2AH	WALCZAK
N1IHH	MINET
UHWMJJVEHW	OCEANE
P1LUCA3	LUCAS
WW2JVKIWJNW	LOUIS
LMYLYBYYEPMYVRYFEAWUUVHL	GENDREAU
LUWISE	LOUISE
MJRRNIA	RANIA
LUD1VINE	LUDIVINE
ZFYAD	ZIYAD
M1HELUL7Z	HELOISE
DY0MIINGUEZ	DOMINGUEZ
Y1CHDQUFT	CHOQUET
0RLANE	ORLANE
VCN5	VONS
MMEHRULTQYYYVLYY	MEHAULT
JYPANE	JANE
GBETIE	GBETIE
MTLPRFZ	TIPREZ
GVEMQN	QUEMIN
WBAR3IER	BARBIER
LAM1GAVWPHBVZUYUVLF	GAUTHIER
HLUG0	HUGO
LEBL0WD	LE BLOND
LIS0N	LISON
EM1JHNNL7	JAMOIS
LMAHDUR0MYYVVYYYY	LAMOUROUX
EHW	EDEN
GWERBIVDVYIVVLP	GERBAUD
YIILNNAFHNHJNHNNNNMLLW	MARTIN
HMW0LNAWAM	LOLA
YPAM	YANIS
WMZMNWENW	IRATXE
GM1LUENE2EYSY1LANAYYY	GIMENEZESPANA
M1LFU	LEO
ALWHXAJIH3HHH	AKAIS
AYVLAS	AVIAS
KFRDE	BARBE
SWMWHA	SHOWWA
Y1MHJARNTLLAHNN0HHH	MARTIN
MBRIS5ETYYYGY	BRISSET
IM1PLAMYBPYERTYY	LAMBERT
WHRII	BAHRI
HPWY	THEO
DELH75UE	DELASSUS
M1ELISA	ELISA
GARR1IGUES	GARRIGUES
WMFMVMTIBVWJY0LUYTIL	VIGNOI
BYARTHEL	BARTHEL
FMFHJ31LYYPUU4N	APOUTOU
WYWTJGEWW	LISE
ANW	ANNE
G1ABRIEL	GABRIEL
LEWNE	LEMOINE
6MARHLIERPPLYY	GARNIER
1MLLUCIE	LUCIE
CALYLN	CALVIN
S0GHD	SOGNO
ELISA	ELISA
IY1H0LEYZYY	MOLEZ
NEL1HERMITE	DE L'HERMTE
EWSYEWV	ESTEBAN
Y1LUCHCL	LUCAS
YUPLYSH	ULYSSE
HM1PFDGYBPYEYRDVNYIH	FOUGERON
M0UGIN	MOUGIN
HHMED0YHSSIWE	AHMED-YASSINE
M6YAXIME	MAXIME
MLUUCIE	LUCIE
FL07KNF	FLOREMR
MAZ20LEWI	MAZZOLENI
YAKHLLF11	LAKHLIFI
INEF	INES
M1MATHIEU	MATHIEU
GY1YYBRYUVNYPVHYUF	BRUN
AMBRE	AMBRE
HYECWK	HECTOR
PLEHRV	PIERRE
FLMWLYMMALUYGTEYTVYGNY	MAUGET
NMLLTAXYILNVYEVY4L	TANANE
VHLEWTIHE	VALENTINE
WA0UZ	BEDNAOUI
MJA5TFEYIY	SAATIEN
BAPT1LIJTE	BAPTISTE
BZNNU	BINTOU
YL1CHENN0UFI	CHENNOUFI
MW1MWP0LVTWJTLELATH4TC	POINTEAU
VMANH0VE	VANHOVE
PAGYNNIER	PANNIER
M0WW6QNI	MONDOLONI
LWE1AWH	LEANNE
BUUK8L	BOUKRI
W6UYFWU	NGYEN
HDURJRANDE	DURRANDE
PAPUCHIJ7TN	AUGUSTIN
BIAUVILLE	BEAUVILLE
MYLYFRLVIPCH10LTJVI4N	FRICHOT
EKHA	EMMA
MEWND	BREMOND
K5UW	KSON
TE1XEINA	TEIXEIRA
YMB0UTDT	RABOUTOT
MLBHEUGE	BLEUSE
MYMPJJYARYDIHVSL7YF0DY	DESJARDINS
MW1MMCHIUAYRYTUJTER0IJWLL	CHARTIER
FMAURE	FAURE
MW1MMWFINRE40DVUJM17IJ6	MERAOMTA
BYLAHH	BLAMM
5ARAH	SARAH
MHHZK0	MANON
F0URW1ER	FOURNIER
YWUCAJX	BOUCAUX
FIRMN	FIRMIN
VALEHCE	VALENCE
BAWUX	BAROUX
D0USSIN	DOUSSIN
H0NHH	HOMMET
MAYA	MAYA
Y1DYLAN	DYLAN
RKYNAUD	REYNAUD
WLWJJWJIRGEIH	GREGOIRE
VMWD1ER	VANNIER
DYA6HKA	DA CASTA
WMFFYYYYPPYYY	BOFFY
GWPY0UYDNLYVGYYVY	GOUDJIL
YY1BENHAM0UZ	BENAZZOUZ
YHW2HI	MANON
WRHAMLF	BARKATI
91J0EY	JOEY
GGUY1LLERM1N	GUILLERMIN
VALEHTIH	VALENTIN
LPL5ARH	SARA
K1C1ECST	HOUSSOY
BV0UKXRIJ5T	BOUKHRISSI
B0URIET	BOURDET
MWARTIH	MARTIN
BLMYA	MYA
EFYLISA	ELISA
CM1T0MASPFINPYY	TOMASIN
PEEHKE	PIERRE
WIAHP0JLJLFHHEHH	APOLLINE
LYPKEEW	CYPRIEN
ZLWJ0EHL	ZOE
U1RARD	GIRARD
TMWLWNWLENM	FLAVIE
HWJULAEJ5HW	JULES
B0VDARD	BOUDARD
HUG0	HUGO
B0URVE5	GOURVES
WLCAULTIFD	GAUTIER
HARAIF	MARAIS
FTAEIIF0P1AH	STANISLAS
FL6ML11MYHHLA	BENBACHA
P1FIL0RYLW	FLORINE
GAUWRT	GAUBERT
L1LL0U	LILOU
YF51M1I11IG	YASMINE
MWLWKWWHNW	LEINA
ADUIIK	ADELINE
EW	EVA
ANAELLE	ANAELLE
INMLCHLLLGARL5	CALLIGARIS
M1THE0	THEO
MYRYL7YEYJYYVVPIVDYY	RIBES
NM1Z0URIDELLE	LOURDELLE
M1ILYIHE	ILYANE
QA8BAL	QABBAL
SANDNH	SANDRA
PCI1WUIIN	POIDEVIN
G1IYDPEVAWAYRYRPYEYH4	DE WARREN
MLT0SWLN	TOSCAN
LWVHLIHYJELYHHH	VIANNEY
MLFVI	EVA
MLDHIIWLAIILJIHHH	DINA
CHB1HH	CHBINOU
L31CLIXANE	ELIXANE
LMLL0U	LOU
SAFRANA	SAFRANA
ARTHUR	ARTHUR
LPLLHATKYISLIAHHI	MATHYS
YHBIN1L	BALINI
UHSA	ELISA
PLATTTER	PLATTIER
AMIWE	AMINE
WMASTNRWIDNM	ASTRID
LWIILERC	LECLERC
CLEMENTINE	CLEMENTINE
M1R0MANE	ROMANE
JVANN13	JUANNIS
YLPAUYYIEBP	PAUMIEB
M1FXM1	EXELG
LENA	LENA
HAKYE	MARIE
LWHY1551IM	LHUISSIER
MCWYRAHAILLKNM	CYRIELLE
MLBEHJAMIN	BENJAMIN
HMNYYYYYYYY	ISTI
MAGWTNER	MAGNIER
LMHTEWHYPYVY	CATTENOY
M1T0NYNAYUYYYPY	TONNAU
M1GTTE0	MATTEO
ALLAW	ALLAN
YWWWI	MOHAMED AMINE
CPLENENT	CLEMENT
W1L0U1S	LOUIS
MQLLKYY	BELLEC
M6ZDUISE	LOUISE
MY	ORY
WMLYVWDIVIITUWWU0	VALLET
ETWW	ETHAN
LKCH1IA1ZT	LAMALLE
JLHAN	ILHAN
W1PGVYLPYY0	GUTU
IWLJWFHW1L0ME	GOUTORBE
WWLMPW0LUUP7IY7H0H7YYG	POUPINOT
PLAURL0LRHEI	AURORE
AL1CE	ALICE
LEFEVRE	LEFEVRE
SHMH	SARAH
FMELYX	FELIX
ASHFAQ	ASHFAQ
LIS0N	LISON
IWWWHSWHW	INES
EYJLIE	EMILIE
AVZAWWFT	AUZANNET
VLEL	VIEL
LH1LL0RYCPYPPLYYY	CORCY
MWMLMAWNM	LOLA
Y1D05SLYCCFF	DOS SANTOS
YLADRIEN	ADRIEN
NM1PMJCHIYLYAYK	MICHALAK
WK7LLIW	KILLIAN
AW1C0RNYLLEY	CORNILLE
211LY	JONZO
IMYPG1YYGHYVILYVPYL	RIRELLI
G0DARPT	GODART
5MUHRWELLE	SUBERBIELLE
LMIK	LEMAIRE
TPPHP0HA5	THOMAS
AXYILLE	AXELLE
KPMN	LEPRON
Y1PATRUYY	PATRU
WMLMWDDLUI0IYCMZNYUJPI	PRESSON
L0UNHE	LOUANE
LZNA	LENNA
LEA	LEA
DMUP0WTY	DUPONT
YP1YEYIGYSTEHJYCHQTWEWKVR1	EISENCHTERER
YATWEU	MATHIEU
ENMA	EMMA
RENAULD	RENAULD
AHPHAHZ	RAPHAEL
F15ANCE1RNE	SANCERNE
M1JULIEW	JULIEN
THUKZRT	THUBERT
HASY4IM	NASSIM
DPYIHITRY	DIMITRI
M1N0A	NOA
KI1JMC	KAVINE
RAYET	RAYET
W1FCTYYTEYKIPYY	POTTER
YERLAHD	GERLAND
MWWYGY	PONS
DWIUE	DUGUE
IMBERT	IMBERT
FLLJVLLLC1TADRNLLLA1NMIM	VICTORIA
GIANNESYNLI	GIANNESINI
LHIILKH	LAURA
AULY	AURY
FP6SABR1GNA	SABRINA
LEFEV2E	LEFEURE
QMILEHB0UGRHSI	LEBOURHIS
WRES	SOARES
W1LM0YWIAYNYWPVLNV	MONTANDON
DME5UYAHPPYYYYG	DESCHAMP
Y1PQLK5MDAGLJ	QUESADA
B1EN01T	BENOIT
Y1ELL5ENK	ELISENE
IYLQE	CHLOE
M1HAHRGLAUHXLHHLH	MARGAUX
SHIRIWE	SHIRINE
CPHARL0NE	CHARLOTTE
H0	THEO
LENA	LENA
P1ALLCIA	ALICIA
MM1MMPAJUULYWYJYLYD	PAULY
RAK0T0	RAKOTO
MLHAELYS	MAELYS
M1MHFFR0	MATTEO
HAWWLLMH	MAXIMILLIAN
ED0UARD	EDOUARD
Y1HFPELP	APPEL
MMYYMYYEGYYAWYMW	ARANEGA
MMATHIEUVFIVVNAN	MATTHIEU
P1LCVP	LOUP
F1PDEJESVS	DE JESUS
HCRH5L	BERHAIL
Y1	H
TUALM0S	FAULDES
GAAUT	GARDET
LMYYEYR0YYUXYY11Y7VVYU	LEROUX
MTAURHKYRPAYYY	TAVERNIER
LEAWNC	LEANNE
RYAD	RYAD
WWLYWNJZV3IBTTZYIZY	TAZIBTE
MAXHCC	MAXENCE
LZLI1NLHFLE1NWAL1NWNM	TIFENN
HRWUHHPJWHH	RUBEN
YVES	YVES
2LEL	DIEL
KALLIHA	KALLISTA
MLW0VMLW5AM	LOUIS
YY1YNY0YEYRVYLFYP	BOYER
LEQNE	LEANE
JADE	JADE
JLLEHAND	ALLEMAND
HMET	HEQUET
DEDDFAM	DEBORAH
M1FHRAH	FARAH
CHARLES	CHARLES
LF10LLLIEHR	OLLIER
WMLMIWHJUQDUKG0L9EQS	CHARGE
JC5Z1PHTNZ	JOSEPHINE
JAC0B	JACOB
CAM	CANDE
T0U0LAW	TOUBLAN
WURHNT	COURANT
LWE0NGYGY	LEON
MLN3ZHNEW1FIYGL	MOHAMED-API
L0UISE	LOUISE
Y6ALINE	ALINE
WLM0UKWW	LOU
MFFAM7	DOSSANTOS
MWH	SALOME
5H1REL	SHIREL
MLNRRLIESARAH	MARIE SARAH
RYAHEH	RAHEM
YPG1YYNPYHSVFY4UVVRYYYP	NASSUR
YJLALLAYLFVP	DALLALI
NMWEYMLWANM	NEYLA
HLWHELJIALJLHHL	HELIA
K0T	KOT
HWWHWWWNW	JEANNE
M1TLBVIA	CRONOS
L0GHT	LOGET
KYLZH	KYLIA
JLCFHSAJEH	SEBASTIEN
MLHUG0	HUGO
S00KAYHJ	SOUKAYNA
C0RWELIA	CORNELIA
ALEXAWWRE	ALEXANDRE
YLX1HIILLLANH	KILLIAN
LY11B0T	LIBOT
M0YAYE1	MOHAMED
LAM07	CAMON
WPYG1Y5YIPVVATPHAIIWHYA6V7AVTHAM	SIVAPTMAVIRVTMAYA
MUMAMRWAAM0	CLARA
BRUEIIZRE	BRUEZIERE
PET1T	PETIT
NELISGH	MELISSA
LAHGLQIS	LANGLOIS
GALFAWC	GALFANO
WW1MWPAIQHFYQ3N1LJUGU	PAREAN
MRAU2HYVUVLF	RAUCH
EYELINE	EMELINE
5ACHA	SACHA
PWENEL0PE	PENELOPE
LWAFAYYP	LAFAY
WHWMTFIWLKW	MATHILDE
CESCUT	CESCUT
JFR3NEYVYLLYYY	JEROME
LAWJDEJLHELHH	ADELE
MLALY55A	ALYSSA
MLLUCY	LUCY
EHYA	EMMA
NYRIUK	NRIZEK
LY0RBJ1WN	CORBILUON
INWHANJ0HNJLH	MANON
YYYLPB0UYYSSVEYPKEYYPP	BOUSSEKEY
0MLALYKEYBVYYJIYY	ALKEBI
MARJE	MARIE
GRATH0T	GRATIOT
MLCHLM	CHLOE
REGAD	REGAD
MJHLCH	JACOB
MKAGE	LESAGE
WKELVFX	KELVI
AHNINE	ANTOINE
PERRIW	PERRIU
Y1L1NRHAYLAAWIHILLAHHLJ	RAYAN
VYINCENT	VINCENT
MLT0M	TOM
LMEFWVRE	LE FEUVRE
ZERTLW	BERTIN
P1MTHE0	MATHEO
GH15LA1N	GHISLAIN
WHLHYYAIHAWHH	LIVIA
P1TADE	JADE
JWLIE	JULIE
NW1DVPEYRRET	DUPERRET
1MYGY1YBYYESVEVHVEVRYVYN	BESCHER
Y1RINUUINI	RINUCCINI
H7ELE	ADELE
LMM1NALQRY	RALARY
LEVDUX	LEVOUX
HAYNLUU	HAMMOU
MM1MKMAIUQTFTYNLJUNY	MARTIN
M1IRPYICYHAFYRYDTYJY	RICHARD
MY1YWHALVRGYEY4JJUW	MARIE
P1ALEXANPRE	ALEXANDRE
MHL1HLEARHHL1HMW	LEA
HGAPDDAD	HADDAD
WLLAYF0YRETY	LAFORET
YLHHHGULFDRT	BEAUFORT
M1NIAG0	TIAGO
JEANNEAU	JEANNEAU
AMBRE	AMBRE
IY1DJEBR1QCN1	DJEBROUNI
HYKRAWD0	FERRANDO
M1LZI2VVYLVNIPYYL	LIEVIN
NPPAELL11S	MAELLIS
MY1YFY0LUY2ARVAVGYNEVA	FOURRAGE
CLAIRE	CLAIRE
MMACARUVYGVYPL1	MACARCZ
1W1LFIGUEPIREDPCY	FIGUEIREDO
TMIMWDYYWGYY	TIRAND
WMERJS0NYPYYI	ROBERTSON
MYLYWAL1EVXVDAWVDVZYYYW	ALEXANDRE
PYILAFCZYK	PILARCZYK
BMAUMTYP00LNEAUWVWQIU	BAUDAT--MERY
Y1WUAL	NOA
LMYJCPHIVAUJVHT7VWY1GD07QQYCTS	CHAUVIN-DOQQIOTS
LMW1MQMU1V1VVHYJ0IJW	QUIVET
MLELQIGE	ELOISE
CHATHKHW	CATHERINE
BUICS0H	BOISSON
RCMERC	ROMERO
YLID0J1	IDOI
HAPPHLEV	MATHIEU
YLN1IS	YANIS
RAFAEL	RAFAEL
WPPPMHAN	NATHAN
JMBEW	IMBERT
MLLFRAYNYTYZLYVPYF	FRANTZ
MAN0W	HANON
LEA	LEA
ZAHWIT	ZAHNIT
M17ALEHTIIN	VALENTINE
MLLEA	LEA
WITLLLTIWCL	JUSTINE
MP1YPYY0YTTITPEYVLIGYYV	POITTEVIM
M1HATTL5	MATTIS
VANDEHBMUCKF	VANDENBROUCKE
RHGNEAU	RAGNEAU
0PSENDEKPAY	OSENSE KPAY
WMLMMLAIUFDY5YFUFLURWJAWI	LOPES EFRWAWDES
YLALESSAWDM	ALESSANDRA
KHST15W	BASTIEN
WMLMUWTLCHYCTWZI7Q74U	UNREADABLE
JIA1YIULUNHNI1HLJH1NMLLM	SOUMIB
3HYLL5TH	BAPTISTA
NATHAN	NATHAN
WMKYPYYYYYV	FIOUX
VMANDENABEELEY	VANDENABEELE
CW0RDJERYVYPYYYY	CORDIER
M1MAYI1LVLYAYVWV	MAILLARD
YLAEA	LEA
EMMA	EMMA
YPLYJYHYIYKALVYYVT	IBIL
MMLL1IYYYYYYVYG	BALLIN
PLEW1	ENZO
MY1YVYAYVNWDATLYJJJ	VANNA
MDWU	MOREAU
VENNEZL	VERMEIL
LEFEVEREA	LEFEVERE
WWWDIWY	GANDIN
LWLFRAYHYDYYYYP	GRAND
NMWAMWNW	TOM
WJ0UVENT	JOUVENT
R0FLLQUE	ROFIQUE
HMHXWDYLMUJYH2YG	FENDY
LAVRM	LAURENT
M1MHXFME	MAXIME
LY1HA5S9N0N	MASSINON
M1HWLH	MATHILDE
MLHERHHWCE	HERMANCE
HPREAUWW	DE PREAUMONT
CA0	CAO
HARJAUX	MARGAUX
LAURINE	LAURINE
CMHEWU	CHENU
MEN1ER	MENIER
MWLLENRWREHH	PIERRE
Y0IHEAU	MOINEAU
LEPAY	LEA
Y1PLAWCHE	PLANCAE
M1PVERVRIYAHPYAIL	BERRAMA
Y1PJERRZCKL	PIERRICK
FUNN1EK00DURALLLW	PONTIER-BURTIN
W1BCWMTL	BENOZT
F1GU1LLNUNE	GUILLAUNE
THHI	THAI
BLLUYJ	BINORD
AMAHDIHE	AMANDINE
NHPH	JOSEPH
WLPAQL0	PAOLO
CLARA	CLARA
AMPL1YYMEYHIHYNY1VYYWV	ALI MEHENNI
C0LIHE	COLINE
FMY1YLA1LYHYAGYTYV6W	CACHAT
JM1ILEYGRVH4HYDYVIY	LEGRAND
UANEHE	DANGHO
5CUHILH	SOUHILA
M1MFTHIS	MATHIS
JHSQEZS	DESPRES
SIM0H	SIMON
TDSELLQ	TOSELLO
MMN	PAMART
SERTHA	SERENA
EMWLFNSWAMW	ELISA
M2ABLNTL	ZABENT
YLTIXVZV11IITLI	TCHA
3QH	SADE
YLELFSA	ELISA
C0NSTANCE	CONSTANCE
MC0L1HY	COLIN
MA20TTI	MAZOTTI
HAPEIVA	MAEVA
TMW0UWRTY0ULU0UYIVYUYJ	TOURTOULOU
MLADRIEH	ADRIEN
CMHAPNAN	CHAPMAN
MY1YYKIYHYBEYRJWVJYY	KIMBERGT
LP6AAMLLNIATNLALNLHLH	AMINATA
P5ILAAUIR1RYIJJIHHJ	LAURRY
BMENNMVVVYVYVY	BENNAI
RAFFLEBEAU	RAFFLEGEAU
MP6YLYLYYBU1JHVHNHI0QL	LLBIHAN
DETERHC	DETERME
M1AKW	ARTHUS
LAMJHUJWJIHWEHHH	AMANDINE
KEVIW	KEVIN
P0CLET	POCLET
Y1TLMETNX	TIMOTHE
MY1YZMIITV0VUYWPVLILVN	ZITOUNI
M1ITZ1ARL	ITEIAR
TRFJTAH	TRISTAN
MLWHMW	JOSEPHINE
LHP1YYHYPDVVT2RVDN	HADIR
6JRARD	GIRARD
WBESTI0HYYYY	BESTION
P1MH0NL	SIMON
D0S5AWG	DOS SANTOS
MM1M6WELNVD4MYVNIUUD	GENDRON
M1LAVRH	LAURA
M0RET	MORET
MFME	FRANCE
MEL1IILI	MELVIN
SANUEL	SAMUEL
BLHARIWE	MARINE
MATHUS	MATHUS
VY0LANS0N	VOCANSON
MMSERMGW1ANW	SERGIA
MM5MDWULBVUMCYBWY	DUBUC
MW1MMTLIJTUUJYHFVH8HDYY	TITOUAN
PDPYLAH	DYLAN
W1LAUQHF	LAURA
PWILLIA5VVVVVYLV	PILLIAS
FM1IEY0N	DICHON
HWTPDEYGRPHYYYIIG	DEGRET
PHAN	PHAN
HMBRE	AMBRE
MARTIH	MARTIN
WTWIMDWT4EENW	TIMOTHEE
NMC5WHP5AJAUYVV	DESCAHPS
EWHAVVET	CHAUVET
5CHIHW	SCHILLER
BAFTF5TE	BAPTISTE
LM1ELISE	ELISE
51N0NNGAU	SIMONNEAU
BG65SEJ	BROSSET
F2ND7AYEH	NDIAYE
MLFYRXY	SARAH
MRISSAYYYYGYY	RISSAY
MW1PL0RVAY5UYYPPY	LORAS
Y1MEZLAH0TTLG	MEZZANOTTI
WBM	BOUTBOUL
MATH1S	MATHIS
G0SNJAX0VZC	BOSNJAKOVIC
WAL0MHUWYYYVV	ALONZEAU
J8DE	JADE
HUW	HUGO
JZZLI	ZAZZLI
WMMKWNM	JOAS
M1JHM	JAOE
P1S0LINE	SOLINE
WLPERRIHEL	PERRINE
JLIZVIN	LIEVIN
YAELI	MAEL
WLQUEKT1N	QUENTIN
SANT0S	SANTOS
W1EMY	JOEMY
N7HTIN	MARTIN
EWWVAMHQHW	EVAN
AMLHPHRNHKIAN	ALTIPARMAKIAN
P1JPLLIYN	JOCELYN
LMYLYPYQLVHJ0K1PSAYHP11VY	POKORSKI
T0M	TOM
HFAA	SAFAA
WP1YYXLLYLLALJDIY14YJL	MILADI
3WE1LAIYYGLPYLL	DELAL
CAPJY5ANDRA	CASSANDRA
M1QAA	SAFAA
NHY	MAE
M1LUCTE	LUCIE
HM1TRYYEYMUYVYYY0L	REMY
JVLLANNE	JULIANNE
DARRIIVUKGRK	DARRIEUTORE
FATKJIK	PATRICK
XIE0	THEO
WY1YWWLVYAJNLI4VEUUL	EAVANIE
ARNAUD	ARNAUD
ZWUBELIHYPLYYYY0L	ZIEBELIN
T1NCA1T	TINGALT
MRAYDWT	MIRAMONT
ISMYAEL	ISMAEL
ABDKYIIAHI	ABDELLAHI
PMLETYVPYYPTY	PLET
E1YLEH	EYLEM
LAJ5HE	LAISNE
UHFLEY	ONFRAV
PMLYM5ELWVHJALNU0DVNVL	BENHAMOU
MMLMQMULCVNTUTHLJLYJ	QUENUM
IYL1DTTARD	COTTARD
MAXIH1L1EW	MAXIMILIEN
PEYNHA	ENNA
LYLANME	AMBRE
FMLHLEXIS	ALEXIS
LPFHYA	LINA
IMLPDUYDLIPGVYYYN	DUBOIS
31HAXELHLIEIHHH	MAXENCE
MW1MLWALHSYDTTCEDJYL	LACOSTE
AMYHYLYLEVJWD00N	ADJALLE
JWTPDUM0YGULIVHYG	DUMOULIN
LER0GER0W	LEROGEROU
WMURYGYYY	BOUR
VHYN	KAYA
ELWH	ELWIN
PP1YYLYE4VQPVURY7QIYY	LEBOURS
FYYPL0YRYMA	FLORYNA
JMPEAWNNLPKWDH7JXY	JEANNES
CLEMENT	CLEMENT
M1NEKQJH	NIKITA
GINLLIFHRNIISIANNLNWLLW	LARISA
WTAJ0UR	OUTASOUR
DM0REN1EUX	DOREMIEUX
WF5TENER	HOFFSTETTER
WLEWZ0	ENZO
MMLYWFL1Y4YYY16TYTAJN	SCHMITT
M1LRDMYPPTYEVAYUVXUN	ROMPTEAUX
FRJHWF1F	FRANCOIS
HAWH	MANON
ANGJFAW	ANGIBAUD
WNSLAM	BEN SLAMA
NFLL0TTI	HARIOTTI
MLWJARJI0HNHHLH	MARION
MMEL0DY	MELODY
CASSAWDHK	CASSANDRE
AMYYGYLYDYYUJYALARJDFPNJII	DUJARDIN
C1WHAPJUHCTHHLEHLH	CAPUCINE
RWU	RIOU
MLTLL0VA	FIONA
AHT0HIC	ANTONIO
CAMWEMXQNLEWQRNAW	QWENN-ENORA
CWHE11LMNN	THEILMANN
UECRW	DECRON
MLSTES5Y	STESSA
HAEVA	MAEVA
G0HE5	GOMES
LP1N0LELMLIHEHL1HHH	NOEMIE
0LEAWE	OCEANE
F1SKALILANI	SKALILAMI
NAXEHCE	MAXENCE
MTKITW	ELISA
LIEBIGHUT	LE BIGAUT
GWLYMMQIAUYFUYVVVUL	MADRU
MLCLEMEWT	CLEMENT
WJWUSMTAINEAM	JUSTINE
YAHKY	MAURY
RM0CHEPVYYPY	ROCHE
FMHJFENJIVVYIA1P	MUSSEAU
P1YDUKHD	MOURAD
P1PAUL	PAUL
FLLJN	ALLAN
LMW1YWP01YTNWE2JJYI	POTTIE
M1MATTH7EV	MATTHIEU
KAYNHK	KAYNAK
R0NZU	ROMEO
KRRAIH	LORRAIN
LTSA	LISA
TMMSH0FRAYSIVYYVYT	TRASHORRAS
C05CA5	COSCAS
YTZ0EHL1NWIM	ZOE
LVKA	LUKA
W1CELE5T11NF	CELESTIN
AMLLYCHBARY8EYYI	ALLION BARBEY
P1ETIEHHE	ETIENNE
MLMAELLH	MAELLA
W1ERIHE	ERINE
P1MLAIJLZD	MATRID
MHTER	JAHIER
AWHJM3JNELL	AMINE
Y1IAVAHIHLHJ	IVAN
LLP6NA0YY1LHLH	NAOMI
WWSJKKRWJLAXW	SUKRULAN
CLARA	CLARA
CHARLY	CHARLY
MELI55AN0RE	MELISSANORE
IWEW	AWEN
MY1YMFIVJHYBJIJV4D	MEJIA
WE	NOE
NALFCY	MALFOY
VMALIFPMINENM	VALENTINE
WMUFMYYYYPYPY	ROUTIER
PTPLLEXAWDREHHI	ALEXANDRE
YPPH0	MATEO
MW5F0NTA1NFS	DESFONTAINES
Y6AZEMIA	AZEMA
YLLUHCAS	LUCAS
JCRA	DORA
BEZ7E	BEZIE
HPERHDR5X	PERDRIX
0EWFT	BENOIT
LHWJAYJLLKJIH	MAILYS
MAW	COUTANT
TMYMYAYMYVVAWYVJ	TALAMON
CMWHANRWINTFNW	CHARLOTTE
MWYWYYCYKUYVGWY	VANDERBECK
G0Y0W	GOYON
W4WFEKVWWNW	YSEULT
DYUARTELEITE	DUARTE LEITE
MMWEMAWWNM	OCEANE
I1M1R0MAIH	ROMAIN
LEPEVDEVEN	LE PENDEVEN
LYLLAUN0WT	CAUMONT
THYBAVD	THIBAUD
LLAUM	LUNA
TAMB31SE	TAMBOISE
M1FRA1YIIQ	GRAY
MTW0SNCWAHEHW	TOSCANE
M1LWIIS	LOUIS
MWDIAMNWAAW	DIANA
M1FARAH	FARAH
JEAWNE	JEANNE
MU1KWYLPLYLLP	DIABY
BENJAM1N	BENJAMIN
MY1YJWELAVNVCS0TUNQWTN	JEANCOURI
TH0NNY	THOMAS
AVLLEF	MULLER
JMWMMNWAVIINEAMM	JEAN - VINCENT
M1CAB0W	CARON
MLEHY	EMY
WBQS	DUBOIS
SERAPHGN	SERAPHIN
MATTE0	MATTEO
ZRAV1LL0W	GRAVILLOW
C0UGKNWLE	COUSTENOBLE
HLHAL	KIHAL
N0AH	NOAH
P1ERWM	ERWAN
WWFUNIWXW	FELIX
IFIANDER30W	ANDERSON
JELESU	DE IESU
L1L0U	LILOU
GMARMIALDE	GARRAIALDE
JHGRQD	INGRID
MHATLHFSHLJ	MATHIS
L31CELESTE	CELESTE
ZML0ZLLJPP	DESBUSS
Y1JANBJAUD	JAMBAUD
2EU	LIA
YEVL0LEFYLH	REVCOLEVSCHI
RCVDEAU	ROUDEAU
P1N0HAMYED	MOHAMMED
M1B1CN0RUH	BENORAB
NMEL1E	AMELIE
GEPRGET	GEQRGET
AHCE	ANGE
JW0Y5EVJJVFVWV	DOISE
MP6YFY0PRYTTFANYDVY	FORTIN
HIYBAJ	THIBAUT
UG0	UGO
AB6RALL	ABGRALL
THE0	THEO
LVC	LUC
JM1QVEKELWLHEC	QUELENNEC
M1Y0HB1AZELTHLHILLIL	MOMBAZET
WL1LI1JJL11AL	DAUQUIER
HAZRAT	HARRAT
FM1LHNA	LABA
M1HAR4	MARY
AGATHE	AGATHE
FWM1MMP0FDU1JHJ7FNYUYK	POUCHIN
RM0VXYLYPGP	ROUX
TWWMM1IWWAM	FABIEN
JSDX8E1PE60HA	ISOMBE-PEGOMA
HL1YNAPN	HEYNARD
WDLH	NOAH
ELRHAK1PCVK	EL RHANDOUR
AW1PREBWH11YYIVIIV1	REBHI
SAHAE	SANAE
D1BKWI5	BENIS
MAM	MARVYN
PERWHE	PERRINE
AMG	ADAM
4HSHIHE	YASMINE
MW1YMLVU11UFAJUUCDQHP1LLE	FAUCHILLE
JMACAM0HYVYLGYVY	JACAMON
GWLYDWAIV1IGVNUVEUNY0RHTNE	DAIGUEMORTE
MLV1CT0R1A	VICTORIA
JULELY	JULES
AL11FGRES	ALI - FARES
WLWARJAWHW	LARA
WA	EVA
MLFLMYAN	FLORIAN
MAXHU	MAXENCE
MML1CTYIYPPP	BOLLEU
GIW1E5	GINIES
AUVERT	AUVERT
CHMHHAHHLLHYJLJLL	CHARLY
HGIYAN	HUAN
ELWUARC	EDOUARD
IP6CLANTHAPLLINYAA1IHW	CATALINA
A1AMBRE	AMMRE
MWSABKFWHNW	SABAH
LMWCUAKWAHW	LOUKA
LYLIFAVYRILFPY	FAVRE
NM1WALVLYX4RTYYYV	WALLART
FRND0S	FANDOS
N0LANL	NOLAN
HEWRY	HENRY
AM1PHALNZYYAYCLYP	JEANZAC
QNLLPI	EMILIE
WVI0L0YYYYPYL	VIOLO
30WNAF0UK	BONNAFOUX
W	TRAOBE
LHLVNGADEHHVTFUR	LALUNG- DE HAUTEUR
P1MAWELE	MANELE
NDELISAYAJ1C	MESSAOUD
IEIVVDS	BEAUVOIS
M5ARWE1HLHLJ	ARWEN
MXGQU1EYYYGYP	PIGOULE
BJAHBARIJ	BARBARIN
HY1YGFYAYLLPYJYFVKTA1P	GALLIFET
MELAHE	MELANE
WKEJXA1XYYU	KESKIN
NAMFI	NAJAFI
MP6YEYYVPRYAYRIDLVITIG	EVRARD
JMACQUARQYVLPYYY	JACQUARD
DELAP0RTE	DELAPORTE
MWV4AMMED	MUHAMMED
Y1MRIMH	DURANAD
PA6HRD	PALARD
M1PERRIWE	PERRINE
LP1SEWHDHNJHP	SENON
DCHATIEW	DONATIEN
P1THHGU4	TANGUY
MMLMMM1LULWLWYNY1ULU1YUL	BOURAMI
31MELYHA	MELINA
WLHAH	JOLHAN
LYLKRUG	KRUG
PIN0ELIE	NOELIE
MWWARVLVEPYVYJVV77T	MARIE
WMLMWDD6HQK6YAZNYN2WIMD1	BAKJOBRIGMA
MW1MPMI0CVHVJATU70LY	PICHAT
TIL1LA	ANNA
TCUNKL	TOURK
J7YEPHLAK	JOSEPHIAK
MW1YWM0ILYYZAYYVIVW	MOLZA
SEV3N	SEVIN
L0RFN20	LORENZO
Z1L1INMLISNIHH1HWIJ	INES
MYLYPB01VNUNKYTJVVLT	BONNET
BEZHKU	BRIARD
W5MATTF0I	MATTEO
MVWFCMTWDRAW	VICTOR
LGWJI0LJ1YHAHHJ	GILIA
HMADJLYPYYYI	HADJI
WPUTHIER	WAUTHIER
AHBRE	AMBRE
LLEBAH	LIEBART
MY1PR0LZVILEVVF0JL0HVAVBERTI	ROZIER-CHABERT
M1H0RA	NORA
AGRELA	AGRELA
CWMCENAWNEAW	OCEANE
ERNHN	ERWAN
Y1VSYH	MOUSSA
TAZL1	TAZI
Y1PDUCYRYWWVXIVYY	DUCREUX
TV0MNN	TUAMMA
LCGAAYEC	LE GOAVEC
CUGUEW	CUGUEN
W1LDVLFAMINLWF	LOUIS DOMINIQUE
NAALLDUWE	DAALIOUNE
HFL0YSE	HELOISE
YI116NNQKLJFIUAKNIKWINM	NELSON
RWXLKQNGYYYYVYVY	RICHARD
MM1YMMLFUK4WZEUYPQTYYI	ETCHEBERRY
MAMATN	MARMAIN
JWPLYTYAIRYDAUVJIIVV	TARDU
LHYP1YYFYAYRTYYI	FART
HYYP1YDYYEYY0WLVLVYYEYIRYA	DE OLIVEIRA
5CHUTT	SCHOTT
YASSIWE	YASSINE
HWDULHNEYUYTYYFYF	HOULINNEUF
BERYA	BERIA
H1QKRYS	MAELYS
EGLE	EGLE
P6CARLAL	CARLA
WW1YDWJIWD7U	ROUE
M1BQNISTE	BAPTISTE
JEAHHE	JEANNE
ASYA	ASYA
PLDAMIIN	DAMIEN
DECCME	JEROME
CKWAYJIJL6EHH	CAMILLE
M1AL1HEE	AIMEE
MTPAULJNE	PAULINE
5AMUEL	SAMUEL
LEA	LEA
VULLLAUME	VUILLAUME
WPMYE	JUSTINE
PICUH0T	PICONOT
M1ALVIW	ALVIN
W6YWYYVNHGAYRIDVVVII	DONNARD
DWRKPIERYYLYVYYU	DRAPLER
NARAYAWA8AVLVRHE	NARAYANABAGAVANE
ALYCTA	ALYCIA
ULVLA	OLIVIA
GAETHH	GAETAN
AWMBRE	AMBRE
Y1AUBY11NYYPYY	AUBIN
BCWHILHAU	BOURRIEAU
EHY	EMY
DAURIAC1GCAYR0U11	DAURIAC-CAYROU
MS	JULES
YAY1LI	MAI-LI
3AULET	BAUDET
CMHAPR0N	CHAPRON
01LENNE	OLEANE
H0AREAU	HOAREAU
VAN1WA	VANINA
L0UIS	LOUIS
MLMARLE	MARIE
DUPL0UY	DUPLOUY
ZHAHG	ZHANG
M1TR1STAW	TRISTAN
C0DDY	CODDY
KRY5TALE	KRYSTALE
FP6ELWME	ELEONORE
DJ0E	DJOE
Y1LAYVGPFVYEPLPY	LAVEFVE
LSWHDMJJNELH	SOFIENE
YL1FN1JLILLIL	FAUCOURT
SEWUAL	SENECAL
LM1HAGUFL	NAGUI
WHAHIA	NAMIA
MM8MERY	BRINGER
M1ELILHS	ELIAS
GMRHMN0KTYLVWT	GRAMMONT
AW1GYLAGLYAYVYYY	BELALA
CARLA	CARLA
MRWT	MARGOT
W1EYA	EVA
RCMAIW	ROMAIN
VLHLENTIWE	VALENTINE
QM1FRNWY1E	FRANCE
AM1HHYFTYPLYHEYAYGUI	MARTINEAU
MXAHTERYYPYYYLP	KANTER
EVH	EVA
Y1CHAIKAA	CHAIMAA
IM1LVTVDEPAPYUPYIY	VIDEAU
MWMEGEHWW	AREEN
LPVCHE	LUCIE
HYEN	PAYEN
600THERAUD	GOUTHCRAUD
ANNHKLLE	ANNAELLE
PWTHL1EG	PAUTHIER
LWAM	LARA
FY0NTA1NE	FONTAINE
ELLN0RE	ELINORE
PIERRE	PIERRE
DERIBER0LLCS	DE RIBEROLLES
HATHILDE0	MATHIILDE
M14BCRYDYEVAPLIYI	BORDEAU
AMFWMLM	AMLOMIM
JPULLI	JAULT
LEVAER	CEVAER
ZL11L1N7H0D8002W1IM	LANA
Y1AL1IDDRNL	AISSANI
FRU5LEK	FRUGIER
JMLKDYRYQYYZZ7YLYLP	PEDRAZZOLI
M14LVCA5	LUCAS
ALMWLYQMA0VUCTTYVHS16	QAVET
LYLCYPR1EW	CYPRIEN
SWYCIYHYUPPXPVJW2JHL	SCIAUX
Y1WUNAY	DAUNAY
HAKLUS	MARIUS
MHDELEZNE	MADELEINE
P1MARGAUX	MARGAUX
HWLE5TUDFY1IG0PI	ESTUDILLO
MAR1E	MARIE
CRDS	CROS
H0KAU	MOREAU
LFF0T	LEFORT
LY1TH1FA3LT	THIBAULT
JFQVFNEL	JOVINEL
NEW1Z	DENIZ
Y1RGILZ	VIRGILE
TG4HIMULT	THI BAULT
CHERET	CHERET
MAEL	MAEL
NM1GHWLGPPEH	GAUTIER
Y4N15	YANIS
Y1CLYEYRDYNYVVY	CLERON
IWY1M0E0VLVAGNUEVVVI	DELAGE
WWKWW	DARE DE NAISSANCE CLASSE
IWY1YLP01YLLITNXHIBPTKLDEV	COLLOMBREN
NAN0N	NANON
LM1CLHLAILRLEHHHH	CLAIRE
7HATH11S	MATHIS
MYLYYLEPHY0VEFLJYVIYY	LEMOEL
HMMUYAPWHREYHM	HUMPHREY
WP1YYHAJY1L4	HAD
BERTUCCI	BEATUCCI
MLGWKHILZ	GWENOLE
LEFDRT	LEFORT
CPYHR0LIWE	CAROLINE
ANELTE	AMELIE
MP1YY5UYY1LILYYAVY4GEYP	GUILLAUME
FY1YBYE1LYHVAJG0JPIN	BELHADJ
EYHHHUELLE	EMMANUELLE
BYR1ZZL	BRIZZI
E84IV1	RAYANE
MY1WLA0YG7A1HRYWVYY	LAGARDE
CAZALI1	CAZALI
MATTHIEU	MATTHIEU
GAMPEH1HAHH	GAEL
PMAWH	PAUTET
MLPDEFY0YUYYL0YUYNYDYUX	DEFOULOUNOUX
UWNEGNERYPYYLYY	STEINER
NCN5UPW	MONGUIN
M1HATHYEU	MATHIEU
ALEKAHHE	ALEXANDRE
PMWLEMRWRE0AMAMIXE	PIERRE ANTOINE
M1DQTU1LQ	ARTHUR
GAAX1EL	GABRIEL
MIFAURY	AMAURY
FHUFNETEAU	GAUFRETEAU
MTHUR	ARTHUR
H0EHZG	NOEMIE
CMYYARYRFEKYYPIFGFJY	CARRERE
0LGVETRA	OLIVEIBA
BERKAXE	BERKANE
W0LHHW	NOLHAN
LI5A	LISA
EILSA	ELSA
5WZLLAMPPFY	SILLARD
CLEMENT	CLEMENT
FMW1YKWA0VVH7W7WN	RAVEL
F1JAC0B	JACOB
MAURIH	MAURIN
M1HLEXHKJRW	ALEXANDRA
LHHRLY	CHARLY
MLML	NOAM
LW0LAH0YJJPJVGJ	LOZANO
BMEAUVAL	BEAUVAL
MBRJHDYP	BRIHAY
MW5MLWULNWGTEDAITUU7VL	IONGEAT
JEANNAUD	JEANNAUD
NATHYS	MATHIS
P1BASLLE	BASILE
LMM1R0DRYIYGPYESG	RODRIGUES
KWEHADYYYYYYPY	MENAD
GAT1WEAU	GATINEAU
LE0	LEO
LP6WLAXL11N1	WAXIN
MLENZD	ENZO
MPPLYBYYIPLVAPUUAFHJJYVHILARBU1	MELANAH-BELARDI
GMAABMIGNNM	GABIN
MEN0FJQPIP	MORISSOM
M1THEVHATHIASAW	THEVATHASAN
NLWJ1TJHAHYHHLJ	NATHAN
ZWVI	ZOE
WJWLLKLWETTENM	JULIETTE
CHYWE	CHLOE
KRTH0NE	BERTHONE
YARY	MARY
P0WESLE	POUVESLE
HTAMAWT	FITAMANT
HALN2J	HASHAS
WWYDTEAVUWWYVPY	PREVOTEAU
HWET1AEQWHHH	ETIENNE
MWPUIS	DUPUIS
MW1DELP0RTE	DELPORTE
AWLLAUZFVYTYYPIY	AUZAT
CHARLNE	CHARLOTTE
6LRAW	GIRARD
VWWICKNWR1NW	VICTOR
RMLVEL0H	RIVELON
HWLLLUVEYR1GYNE	LOVERNE
CLEMEYT	CLEMENT
MMTYPBE1VISYJEVUPAQ	BESSE
FM18MBN2	AMBRE
BRATK7W	BRATKIW
L0YRWA	LORNA
SMLIMMILY	SLIMANI
ZINLPHAALJ0PYJAIHNNWLIM	PAIOMA
WMWQMIWNENW	DORINE
WMYEBWERPWYWJJH	WEBER
XCCRM	DECERGY
HP1YYWYUVTFUJRGTPEIRG4	COUTURIER
WU1J	LOUIS
A1S0KK	SOLENE
REVLAT	REGLAT
JANNE	JANNE
Y1S1LM0N	SIMON
TAS5AUX	TASSAUX
STEINETZ	STEIMETZ
TKVCCH1	TRUCCHI
WUILLDH	BOUILLON
LMLJEAN	JEAN
MLLAJMBIRJEI	LABARRE
ITRUHK	TRUNK
CWTIW	CONTINO
MY6WSUIVHUJVRLJIYU	SUEUR
LUCLE	LUCILE
1P1MHAWE	ROMANE
LLEN	CLERC
CLILEN1Y	OLIVEROS
YLQAEL	GAEL
NMFQUTFW	DEQUIEDT
AWK0EALJIEILH	NOELIE
M1PLELYVGYAYUXGVY	LELUUYAUX
MLJNES	INES
31JAHNLN1HL	JANNA
CYHRLEWE	CHARLENE
W1YDNNNF	MANON
M6L0U1AWE	LOU-ANNE
L1LNA	LINA
WMU	PECOU
Y1LALURWN	LAUREEN
FYLQYRMN	FLORIAN
NMLB0URLLEYREI	BOURLEYRE
LW1UHWEL	NAWEL
MM1YJM0LUHNLTL7JJZ	JOAN
ALEX15	ALEXIS
MYLYMWA1HVHLE7VSVIJH	MANHES
YLAWLAYS	ANAIS
LMWLYYAAIWSLTDYHDYJYYI	MASLAN
BESSAI	BESSAI
MAXENLE	MAXENCE
K1LLILAN	KILLIAN
MATSE	BLAISE
CMEVAUDYIYYYYLY	GEVAUD
MY1YTFFLUVUVJLLVILVAVRADY	TROUILLARD
0SCAR	OSCAR
LM1THE0	THEO
AMYG1YIGYLYLYJJVITJY	ILLY
MAWLEAXAAHDREAW	ALEXANDRE
Y1XW0LHE	ANTOINE
GMTBAY55YETYY	BASSET
FMMMMTMWANM	FATIMA
CECJLE	CECILE
LER0UX	LEROUX
Y1NEG	MEG
MAENA	MAENA
M1B25TJAAN	BASTIAAN
KMPAWYPUPPSWYYTVYY	KABOUS
H0UWA	MOUNA
KEPVYYN	KEVIN
WNMAEKLWLENM	MAELLE
LYP0U	LOU
MMAMMYYYFYYP	MAZZOLA
YLREVAVLT	REVAULT
M1WARLCTTE	CHARLOTTE
CH0WL	CHORIOL
MM0RLN	MORIN
MCML	SENEGAL
P1WLEWE	SOLENE
Y1H0MAS	THOMAS
MMXRWUKWG0PYYTU	MARZOUK
M1Y5AURI	YSAURE
9HWCN	SHAVON
F0ULCW1	FOULON
MLP5CVHLYYYCPJWJY	SCHLUEP
LFNH	LANA
3AURHIN	BAURAIN
YLGULLYLAUMGAIH	GUILAUMAIN
Y10CEME	OCEANE
VELA	VELA
KRHLLE	BERTILLE
TH1BAUD	THIBAUD
CZSAR	CESAR
ANTDINE	ANTOINE
KYLLAN	KYLLAN
MWLYWGU0VJJCHD7AYRVN7VL	GUICHARD
W	PERROT
MW1MQMWLYSQYAUDYMN	RAYNAOD
SJCHDN	SOCHON
THWASSILHK	THOMASSINE
ENLLIE	ENILIE
LMEFEBVREYYYYPYPY	CEFEBURE
MKREHLYWNWUI	FEREGELY
HIMLE	MAROLE
GIFAV1T	GIRAULT
MM1Y0WDL1IULYQ7YINH	ODIC
LMLFSLAM	ESLAM
GU1LLAUHE	GUILLAUME
CWMLANAWAHW	CLARA
MY6MNL12VJB5GGLYTVI	DUBAIL
ALM	ALBA
KYLL11AN	KYLLIAN
MYSI1LYLYPPYLYF	HOEL
MK0NFE	LEONIE
AFTHUR	ARTHUR
W1Z0E	ZOE
DAMLA	DAMLA
M1ANHUR	ARTHUR
THJGUT	THIBAULT
YG5	BES
HMHYFYGYP	ANCEL
YLELAMAI5	LELANOAIS
FMHWE	FONQUERNE
MHWHWHJLIAHHH	CAMELIA
MXRTMNN	BERTRAND
Z0EL1E	ZOELIE
FVIVZYZHL	CLEMENT
MLPVEYPCYI	QUEVA
0M1BUYRAZYEPYLJY	BELRAZELI
CIIRIIWE	CIRINE
L0ULS	LOUIS
BR0S1LACAH	BROS - LACAN
N0REL	MOREL
FLCLDVIL1JLILHLH	CLOVIS
VARV0UX	VARVOUX
V1VJAHD	VIVIAND
JGDRLIAWLH	ADRIAN
YL11LNHJELN0AI0JNE0NNWIW	HELOISE
FFM6LSYYASYTYRYEYVVVN	SASTRE
LWL1LY0RSE	LILY-ROSE
A1JWLJETTE	JULIETTE
RKLLHIM	PELLETIER
SDLENNE	SOLENNE
LLMY1YMYL1LTVRP0FVVN1CVIY	MITROVIC
IEWH8INNJHH	ERIN
WMYKAYLA	MYKAELA
IRH	IRIS
AGBTFAWUYE	ABBI AWUME
VWERRXYVYPFVYY	VERRI
M1WTLLEM	WILLEM
TLXLER	TIXIER
LSMJTAJWIJSLHASHJ	STANISLAS
7J0T	PIOT
GAUTHIER	GAUTHIER
MLGABJH	GABIN
R1CHARD	RICHARD
SLMJANLYL	SAMY
AWIU2EWL	ANDREW
M1HCHHHED	MOHAMED
LUUDREY	COUDREY
M1AMFM	ANTOINE
ALBAW	ALBAN
JUZG	JULES
LERZY	LEROY
CAINJ0	CAINJO
AHICE	AMICE
M1ANNIC1NE	ANTOINE
UMVKHWVNVNIVYA	LIVRAN
INANE	IMANE
AXEL	AXEL
DMUR1I2N	DORIAN
N0EHIE	NOEMIE
IM1EYNUA	EYNOLA
G0DI	GODI
LM6CEELF1E	QUENTIN
CWWLFKWWNTTWENM	CLEMENTINE
M1IHY	NAX
HMKEHETYPYYY	HERHET
AALEHFINT	MALENFANT
AMRI	AMRI
DEBRRRHUL	DE BARRAU
M1NAW0N	MANON
WL5MARYJPAYNYY	MARIAN
Y1KUCBP5	LUCAS
HEERSCHMAN	MEERSCHMAN
W1YLLYA0YIYYYPY	LIAO
Z1110PAAULLN0NNLNM1IW	PAUL
HECT0R	HECTOR
WMAUXP44PN7YYY	RENAUX
EIEAH0EE	ELEANORE
WAMLBMAWNEW	ALBANE
HAKIH	MARTIN
WIILIFTT	LAMBERT
MIWL4AAWHHW	ILHAM
MWTHINBWAUDNM	THIBAUD
ANANDINE	AMANDINE
YPLYCYHYAVWYWVEAYUY1	CHAUVEAU
Y1AMARAWDE1	AMARANDE
Y1LAG05YTIYNPDGY	AGOSTINO
HMYJYRYHYVDUERVUTUUU7	RADERT
M1ALFXAHDRA	ALEXANDRA
WMMYMAWWIMWI	PAYAN
MWAYUI1C	MATHIS
CHCUHL1ICK	CHEVALIER
PLEJA	EVA
EMMA	EMMA
LECLERCQ	LECLERCQ
31AWBLLW	AUBIN
TLPHALWE	TIPHAINE
YALTC0	MATTEO
BMIWETYYPYP	BINET
WHL	BEDEL
GF0UBEAUX	GOUBEAUX
TASTAYRK	TASTAYRE
ALA1EXANJRE	ALEXANDRE
WPINYWMANUELA	WINNY MANUELA
PEYRUQUE0U	PEYRUQUEO
M1ALEXIA	ALEXIA
TEILWT	TEILLET
MW7M5INYYLYY	LAVERSIN
MLAKKA	ANNA
KVIN	KEVIN
SLA5I	SIADI
YIP1LSHA0KNHQHNNNLNWLW	SARAH
G152M0HY	SIMON
MAYRTIH	MARTIN
F2AHDFQLI5LAKMUALW	FLANDROIS-ARDOUAIN
J1UST1INE	JUSTINE
LEHLKHAYER	LEMKHAYER
Y0AH	YOAN
MLWJARJIEJJLHHJ	MARIA
W1FLDWAN	FLORIAN
THCYA3	THOMAS
TH0RNK	THORNG
LFSALWT	LE SAINT
LMARQADEI	LARRADE
SLLEJH71JHLJ	QUEATIN
Y1ALI	ALI
3LILYM5	ILYAS
MWWLMWWENW	AMINE
AWWA	ANNA
HG0CCHI	MOCCHI
EMYP2YEYEYYYFPANPTJU	GREE
WEHGYZ	NERGIZ
N5WANYNVGELHW	SAMUEL
MLRI0YUPIYYLLLENEUYE	RIOU VILLENEUVE
LM1LDUWES	LOUNES
YLHHAXLL0HHEH1	MAXIME
P1AHANDINE	AMANDINE
WWRAJNAQALHW	RAJAA
CHAHBEYN0W	CHAMBEYRON
WWGLANDWYSHW	GLADYS
AWMUGNDWHW	AUGO
M1C0RENTJW	CORENTIN
Y1LAHYDRPJYWY	LANDRIN
LAYERGHE11P0UGFT	LAVERGNE--POUGET
MWMWHW	C
VHENTFYE	VALENTINE
HNT01LNE	ANTOINE
HURY	NURY
HJ0T1VA	NAEVA
6ERBEAU1VERLEURE	GERBEAU-VERLEURE
PMPAPTHIEU	MATHIEU
EMHLL	EMMLE
YLARLTHLUR	ARTHUR
YP1LSYSAL	VISSAL
MARCATD	MARCATO
AFNZ0	ENZO
CJMC1IL	GABRIEL
UHG	UNG
ABJGALL	ABIGAIL
REUTTER	REUTTER
WMIMTWNLDVFIQJDH0PY55F	JOVANDET
BHWAT	BARNAT
AW1WHHWYWMYY	LE ROYER
FHLL	FALL
GIRHUFY	GIRAUPH
MUAG	OZUAG
AHBRK	AMBRE
AWLPCHEYIVRPP1EYRPL4	CHEVRIER
TMWHWAWHW	THEO
VMIS5ACYIPYJVPY	VISSAC
MMWHTAHQ15NW	MATHIS
Y1LL	KILL
MYIMER	POIRIER
M1SALHA	SACHA
YHAASSAHDRA	KASSANDRA
FHRRET	FARRET
HYAHAY	HAMAT
THWAS	THOMAS
REM0ND	REMOND
Y1FANNY	FANNY
HWARI1WF	MARINE
DALLIES	DALLIES
WVX	LOUIS
MJWSSEH	WISSEN
MRW	MARGOT
LAMACHE	LAMANCHE
CHAMBA2	CHAMBAZ
RHKAILLL1ER	RIBAILLIER
WFWLHNMWE2LHW	FLAMEZL
EYPLLEMXAY	ELLEN-RAY
MYIL	BRIL
NAL5	NAIS
FMWLMCWLL0VPUIYNVVUUN	CLOPIN
LMWNMHW1LY	DAUSAR
P1HAEL	NAEL
DJIN0	DJINO
ALLCL	ALICE
HPYH	OSCAR
NHL1KA	MALIKA
3EWTALM	BENTALEB
YIHLAN0N	MANON
5ACHA	SACHA
M1HARGAUX	MARGAUX
FWLTH0MAS	THOMAS
MURCNUBERULLEU	MORENOBEAULIEU
Z1CI	ZIDI
GMAMW	GACHON
M17YLAN	DYLAN
BERENICF	BERENICE
CHARLE5	CHARLES
SLUWARZ	SCHWARZ
LMEL0UT8EYPPYVIJP	LELOUTRE
0UMNYM	OUMAYMA
J1YFH0H	MANON
WMNLH	PAUITNE
WRE8NPER	REGNIER
M1JQHAI	JOMAI
CWWLAKRWANW	CLARA
M1MNWIHNMWN0	BARDIN MARINO
HME0JAHR1Y	MEDJAHRI
MWWCKAWSNW	LUCAS
CHERKWTE	CHARLOTTE
M17ASILVA	DA SILVA
M10CEAHE	OCEANE
LPU0U	LOU
EFKBHV1T	GERBAULT
IWLG0VZ0NNAT	GOUZONNAT
LLY1P1LERLKE	PIERRE
YLTREP0P5Y	TREPOS
V1CTNH	VICTOR
LYULY1E	LUCIE
AYHFRIL	AYHERIC
PPPAULLHE	PAULINE
M1ALDINPUUI	LOPEZ
CAHLLLE	CAMILLE
ALCA	ALCA
AP0LLIINE	APOLLINE
MWLAYYYYYYYYG	DOLAY
LMLHUG0	HUGO
KVLA5	LUCAS
FIUHR	FLUHR
APWTYMNYW	ANTHONYN
5TELLN	STELLA
WPFKA	PIRA
LYPY1YYYCHAYRPBYJPTYYYY	CHARBIT
AXCIU	AXEL
WIVANE5SA	VANESSA
MYLYRYYAYVULITY0JJUN	RAULT
FANNY	FANNY
JMMUUNSWNM	SULES
TWWRLG5W40NW	TRISTAN
M1EVA	EVA
WFMF	WANG
QUYEMIN	QUENTIN
XEMJ	REMI
PP1YLYHYGEATJYJVYV	LAGET
CARLA	CARLA
CMUSF	COTS
IEMC116L1CY	LEMELLETIER
BEZIAT	BEZIAT
L1P1LJ1IHLLDITHILS	LHOSTIS
BELIRGE0T	BELORGUET
EYLBRTMI	ELBATMI
MKTTHIIA3	MATTTHIAS
MPSYNEL1R	ROSAPIE
VAUTRJV	VAUTRIN
KIMBERLEY	KIMBERLY
AVDF6ME	AUDIGANE
Y1THUBAVLLT	THIBAULT
Y1YASMINA	YASMINA
HM1PBRWYYSVYHLV1TYEYYLLECHELA	BROSSET-TELLECHEA
P6HFRGAUX	MARGAUX
HWIL0IA	KAMILIA
MEWARD	MENARD
WRGANE	MORGANE
MM1MWLIIHUH5HDT774Y2Y	CCHULTZ
HYAVRYYLFARTSS1	MAURY EL PARISSI
CPVLARYXE	CLARYSSE
YLPTAM	LIAM
Y0HAWW	YOHANN
ELLI0TT	ELIOTT
ANH0NY	ANTHONY
LLWWLYLVMA0FULYLYWA2WWW	VAILLANT
BNDTEL	BROTEL
IM1FELLLHSELH1J	POUSSEAU
MMLYHWDIVFJLAYCLK00YY	HOFLACK
MW6MWHKFBV0CHJCLYZW	MAACHE
