BENES	BENES
LUCLE	LUCIE
EHHF	EMMA
ELISE	ELISE
HONNILT	HONNERT
PAVLINE	PAULINE
ROMALN	ROMAIN
CYRIELLE	CYRIELLE
LILOU	LILOU
NLTHLEUX	MITHIEUX
THOMAS	THOMAS
HNALLS	ANAIS
JAFFEUX	JAFFEUX
PMREVOST	PREVOST
RMANE	ROMANE
BRUGERLE	BRUGERIE
LIORFNTLN	LORENTIN
ELISA	ELISA
MAUPAS	MAUPAS
YETSLSA	MEISSA
XIILSTIU	REBACH
ERNLLLL	ERWAN
AMBRLOLSE	AMBROISE
ELWXXALI	ELBAKKALI
DENZLNF	BENZINA
LAQWRRIERE	LAQUERRIERE
YAEL	YAEL
VITREL	VITRE
GUELLMGOGUW	GUILLOT GOGUET
NATHEC	MATHEO
WAL	SHA I
VILTORIF	VICTORIA
WLRBIEA	BARBIER
DUPRAT	DUPRAT
LEBAQH	LABARH
RCMI	REMI
ARGITXU	ARGITXU
XCDKLILSUEY	RODRIGUES
HIZWLNE	AUBANE
ELLYISA	ELISA
PAWOURIL	ACHOURI
ADROGNE	ANTOINE
JULIE	JULIE
TROUVAY	TROUVAT
CORALLIF	CORALIE
HVANDENAAEFLCI	VANDENABEELE
ASHLEY	ASHLEY
AHBROS	AMBROSS
GAROT	GAROT
HILIANIITHIM	MILIANI-THIBA
THLLFFO	THEO
VILNLENT	VINCENT
LOUFS	LOVIS
VLERSTAWTE	VERSTRAETE
LVCL	LUC
CLQLLO	GUILLO
COLLIU	COLLIN
FERON	FERON
WUHESNEL	DAUMESNIL
BOVTET	BOUTET
BEKNARD	BERNARD
WNLAHW	BENLAHSEN
CCSSA	COSSA
AFLOELLL	BELOEIL
MARTFNJL	MARTINS
WCOHHIER	BRACONNIER
GAPILSTE	BAPTISTE
SALDANI	SATDANI
VIUFOTAE	VINCOTTE
LULL	LUC
GARCIA	GARCIA
ALEXANDRE	ALEXANDRE
HALTET	MALTET
PFFREZ	PEREZ
ANWE	ANDRE
GUST	GUST
LLLIJF	LIUUT
CLAWL	CADWAL
WATTFEZ	WATTIEZ
CORDON	CORDON
RHYXLALN	RAYAN
CUCHERFL	CUCHERIL
FONTALNE	FONTAINE
SIWN	SIMEON
GARCIA	GARCIA
LFGRANO	LEGRAND
COLRFEWIW	CORENTIN
IUNTH	ENATH
EMNA	EMMA
YOINTE	MOLDE
TDISTAU	TRISTAN
RODRZGUEZ	RODRIGUEZ
PHAW	HAJJI
CROFNNE	CROENNE
LIFLOU	LILOU
YOCOUBI	YOCOUBI
NUJEY	ROUES
LYLZYLLYLR	MAXIME
YWWA	GIBAJA
ROWRT	ROBERT
BELOILLSRIW	ELOISE
AHAL	AMAL
DYLAN	DYLAN
ULEO	UGO
FLORA	FLORA
ELOANI	ELOAN
HDVALVLT	DUAULT
BWSSAW	BROSSARD
GWENOLA	GWENOLA
TAXGUIX	TANGUY
LLAFULXLIE	CAROLANE
EDUAR	EDGAR
LUJOUX	DUHOUX
CLEMEXTIGIUTJEQ	CLEMENT-GAUTIER
THWAS	THOMAS
CSIAR	OSCAR
SARAH	SARAH
CAUTHIIER	GAUTHIER
GULLHEH	GUILHEM
YOHGN	YOHAN
HLAPA	KLARA
BENMEROUF	BENKHEROUF
PERBINE	PERAINE
REDA	REDA
COZIN	COLIN
HFNEUVRLER	HENEUVRIER
HELLEM	HELENE
CHARLOTTE	CHARLOTTE
QVEHERE	QUEHERE
GFNOO	GANOO
LUUIS	LOUIS
BERGEAULT	BERGEAULT
GULLLEMETTE	GUILLEMETTE
HUGO	HUGO
GAVETTLL	GAVETTI
RAWKLLNLI	RAMERINI
AAUD	MAUD
GCRLN	GORIN
TPHLRLON	THIRION
COUUS	COULIS
ARAWV	ARADJ
FLORA	FLORA
AYTCRLCH	AYMERICH
NOEL	NOEL
ELTSPA	ELISIA
SASHA	SASHA
BONNEE	BONNIE
PINEAU	PINEAU
PLSCHDN	PLICHON
WHANEDUWLI	NOHANED-ALI
TONS	TONY
ZBOHLIMIW	ZOHRA
GUELLFT	GUILLET
ALLDY	ALIX
FLAVLIE	FLAVIE
GROLLEAU	GROLLEAU
NUGUE	NUGUE
BOWNEFOUX	BONNEFOUX
ALMNAJS	ANAIS
SOLENE	SOLENE
IHARTRIN	CHARTRIN
SJHON	SIMON
VAUL	PAUL
SLHELL	SCHELL
ABRLEN	ADRIEW
POLLET	POLLET
URBILX	ALBIN
MLHAII	MIHAI
LILIAW	LILIAN
MHKTLW	MARTIN
TUEJ	THCO
LECAVDE	LECAUDE
LEO	LEO
DPDTHFEU	MATHIEU
MVOUIOELDRNE	MVOU DELORME
COADEILAVABN	CONDE-LAVALETTE
AIYSSA	ALYSSA
AFULLLNE	APOLLINE
ADRIEN	ADRIEN
PEPRLIR	PERRIER
HENAGER	MENAGER
CLARA	CLARA
UWLYO	MUGO
LPUCLE	LUCIE
BRUGERDLLE	BRUGEROLLE
PIGUET	PIGUET
JAVBEPT	JAUBERT
QHEMTFN	QUEMTIN
AXELLF	AXELLE
TLLPSTOUAN	TITOUAN
LUCIBE	LUCILE
HFNCHAND	HARCHAND
BLYILILNW	BRITNEY
HOWEULLU	HOLLEVILLE
CLARA	CLARA
AWE	FEMIET
ANAIS	ANAIS
WLWHILLE	CAMILLE
KHELCURI	KHELOUFI
WUE	CHLOE
BASTSW	BASTIEN
UOEHZ	NOEMIE
BLOWUHU	BLONDEAU
LYNDSAY	LINDSAY
BRET	DERET
WHUET	BEHUET
SY	SY
OKICIAFU	BREGEARD
KELLLAN	KELLIAN
DEBMLLEUL	DEBAILLEUL
IDFSTAN	TRISTAN
LOUCSILDUP	LOUIS-LOUP
AURELFEN	AURELIEN
XYLLAN	KYLIAN
VALENTLN	VALENTIN
GAVTLIER	GAUTIER
MALWYON	MANON
DECENOUILLAC	DE GENOUILLAC
HENRL	HENRI
VOLPF	VOLPI
WGUER	NGUER
HAOUACHE	MAOUACHE
YAADY	MARDY
DURAUDI	DURAND
CLENENCC	CLEMENCE
AMCW	ANTHONY
CLEMENT	CLEMENT
LOUCQF	LOUCIB
BEGUE	BEGUE
SOLAL	SOLAL
WX	DEBBLASI
WRIE	MARIE
CHEVFREAU	CHEVEREAU
CHROLUZETYIVIEN	CROUZET-VIVIEN
LOULS	LOUIS
NNOFEL	NAOFEL
CAREOLJOBERT	CAREO-JOBERT
LOUIS	LOUIS
BRLIUN	BRION
BACHELARD	BACHELARD
AUGUNEN	AUGUSTIN
DOUSNIZE	BOUSTIE
LYDFA	LYDIA
FLLSCXW	FISCHER
CHAMALON	CHAMBRON
YASSIH	YASSIN
PFMY	REMY
ALEXLS	ALEXIS
CYLERQUIH	CLERQUIN
BENALIEZ	BEENAZIEZ
JYEU	JEU
HOCH	KOCH
RAHSEYER	RAMSEYER
FLERROS	PERROS
LYRXNDLOV	CHAMPION
HUW	HUGO
LJERVE	SERVE
LUCAS	LUCAS
DROINEAU	DROINEAU
ROY	ROY
BMORLCS	BORIES
IWSRDYUNNEVNNGLOLULL	ROUMENGOU
LYLZIILEILEINISKF	ZIELENSKI
WLRUE	DELRUE
PLLSSNNLNIEDANDNNLNMIIM	SINEAD
CMROTLAT	CROIZAT
WLLULLELLLWVSIKVYNV	ZIELENSKY
LPLASALITLIEL	ASAITIE
PALVLILLILE	PAULINE
COUDARU	GOUDARD
TWOUUSSFLLLVLIL	TOURESSE
ERLLYXA	ERIKA
USQ	ELSA
KOURSSNA	KOURISNA
LPSE	LISE
IMYSTOLLIILLALYUNGANLAL	DIALUNGANA
COMBE	COMBE
LLEGLER	LIEGLER
NOURDIN	NOURDIN
LWMLSRMMAIAUTLLLLLOVI	MAATI
MPLMJUILJVSYFLILJL	JOSSE
MEUNFFR	MEUNIER
WLBENSAMLW	BENJAMIN
RELYALRE	DELMAIRE
IMSGWEGLUENLLL	GWEGUEN
WSSARAH	SARAH
FAANLILEONARD	FRANZ-LEONARD
TWJRX	TEIXEIRA
PLSSIHACLHHAIILNWIU	SACHA
DALLI	DALLI
MMLRHNLOWWVSVWUL	GEORGES
FLOAA	FLORA
BWOILTIL	BRIOT
IWSLFLILLLLOURNLLLL	PILLON
LASLDORLAVRJDVLLLL	MORARD
AMWMNHWVRHM	ARHUR
THIBAULT	THIBAULT
FUGUE	FAUGUE
WSRAFAIL	RAFAEL
LEPAGE	LE PAGE
MLEOQOANVNEJCVUJLJR	LEOGLONNEC
LLPLYFUJLRDILYHU	MFUIDIMAU
BAROUKH	BAROUKH
CWLENENCE	CLEMENCE
SHARON	SHARON
LULERE	LECLERE
DUINY	DUFEY
WIFVAN	EVAN
WSHUSOJ	HUGO
UICOLEY	NICOLEY
MMSPFMFIVRCJJHNFCTWULN	FERCHECHE
LMMSRMRWIUYFLVVUUL	ROOSE
BORJON	BORSON
WLAYHERZC	AZHERIC
MSFELIX	FELIX
PILHLLUEYTVVHLVVLL	HUET
PSNAXINE	MAXIME
MMLPMOIYFLDVJELTJXYJ	POILVET
MYLLNE	MAYLINE
MMLPRKHLVEUFLLVOJLPLIVLKLUCLI	KHETTOUP KACI
LWLCHAVOTL	CHAVOT
IBEULMLIXI	BENJAMIN
WSCELLA	CELIA
LVATO	LODATO
NLMAXCNE	MAXIME
MMSRNMOLRLLELLLNLV	MOREL
FVFNAS	EVENAS
MWMMWAWNENW	ROMANE
PSLEA	LEA
HLNFB	MARTIN
IMSWXDBXLXHHALFILUA	ILLIAMHAJIUA
WOVALLLES	NOVAILLES
MIARLGAUXLLL	MARGAUX
PMSVNLLVLLSLYALZLILL	MUSIAL
PICHARLES	CHARLES
BAYLEN	BASTIEN
PSKOMALN	ROMAIN
PISAHALII	SANA
NMEJFSUSTESXEDRA	DEJESUSTEIXEIRA
LMSLMAVLOIUVNFVAVLIULOUUA	HAVOUNIA-KOUKA
WSFWILH	FATIH
TATLLAHA	TATIANA
WWILLONHET	GUILLONNET
WIDOLIL	VATEL
CORENTLN	CORENTIN
LPSELOLSE	ELOISE
HELAL	HELAL
MJBEAANGFPE	BERANGERE
BYENMOULBLED	BEMOULBLED
LI	LI
LWMULLLNN	LONG
MZPIERRE	PIERRE
WWLUCNUWJINW	LUCAS
LARRLCU	LARRIEU
MLDYE	JADE
PLNORINE	NORINE
WSGREGOTRE	GREGOIRE
HWTVLNF	ANTOINE
ISCLJLAWL	SOPIANE
WIGLRFRDFT	GIRARDET
VAPLENTLN	VALENTIN
HLWLAXJEJNCEHIW	MAXENCE
MSSULTAHI	SULTANI
IMSLREYGALRDLILL	POEGARD
PIMANONL	MANON
MSIMFNE	IMENE
MSLVLEYKLLEVVYLCLNVHR	VERLEYCN
PSPLIERIKEL	PIERRE
ULLIILTY	DUCULTY
WSMIAANA	MIRANA
ENNA	EMMA
ALFXANDRF	ALEXANDRE
IMWCBONLLONL	BOUILLON
JLYIUJLELLL	JULIE
ALBAN	ALBAN
POMALN	ROMAIN
ARTUR	ARTUR
PSBREGUN	BREGEO
WFSTPVVLVELVLVUJJLI	PUES
MLLLSTDLESLSVELLVREV	DESSEVRE
WSTANE	JANE
WCCORALZL	CORALIE
TAILLEFEX	TAILLEFER
FLEXDNDPLC	ALEXANDRE
IMSEVEWILLL	EVEDJI
WLUCILLE	LUCILLE
JEIAEIHY	SEREMY
PLESTEBHN	ESTEBAN
HEHDL	MEHDI
RAPHAEL	RAPHAEL
PSANANDINE	ANANDINE
CHLOE	CHLOE
SWIWLLLLLTL	SIAD
PIISNLNFALHIINLNMIIW	LEA
PSVALLLEMLLN	VALENTIN
NUIL	TOUIL
WMLLLLLSSLYIVVVWJJIL	VERISSI
HCRBRETCAU	HERBRETEAU
LWECLERCQL	LECLERCA
WWCECMLLWLEW	CECILE
PWEETERMHHLRSYVLILL	PEETERMANS
PAPOT	PAPOT
MIADELYS	ADELYS
BRUH	BRIAN
FJGLEL	FIGIEL
WEAZCUZLLVLL	HAZGUI
WLECOUPILL	LEGOUPIL
CORBELLLNI	CORBELLINI
ALAHIBINANI	ALANI BINANI
PESCE	PESCE
YANM	YANN
MSLOU	LOU
FPER	APER
SWEMARLLLL	SEMAR
VLCTOA	VICTOR
PLLLSLAOLRLBULLILLL	MORBU
WLW	LOU
HVGUSTE	AUGUSTE
WNLVOFEL	TAVOREL
CNAPELVLEA	CHAPELLIER
WSNATHAN	NATHAN
WERAILSCHE	GUERAISCHE
LECUNFF	LECONFF
HMSRVRELYVJLVLLYV	REY
WSMATTHLIEU	MATTHIEO
CMWOWIWIBLNIH	CORENTIN
LILTCLLTLI	SARAGOSLI
NESET	NESET
IWIBELLBLALCLIHTNRIL	BELBACHIR
WWWLTNAML	WITTMANN
XSELWIARD	ELOUARD
PLPAULLVE	PAULINE
LWSLGLLUIYLBEIRLTLYVL	GUIBERT
HOUL	HOUL
LWKIYLJIHXNHLLL	KYLIAN
ETLFVF	ETIEVE
NATUAN	NATHAN
VASSAL	VASSAL
KLYLIAN	KYLIAN
HUGO	HUGO
MSLALLLOILHLGLL	ALLOING
BRCCHLER	BROCNIER
MMLPMAIUCYHYUUONYYD	BACHELOT
LMSDEMONNLLLET	DE MONTILLET
UUFLLAUME	GUILLAUME
HALAURY	MALAURY
YSRAFILINLIIGAUBERT	RAFINI-GAUBERT
PSCWSTANT	CONSTANT
VESSEDO	VISIEDO
MELZSSA	MELISSA
AWSLSEGULLILNELAILUV	SEGUINEAU
HORISSEAU	MORISSEAU
DLARNA	DIARRA
PSCONSTANT	CONSTANT
LWAMDE	LAMPE
WMSMBMPLUUYJFLRLFLZOU	BRUYERE
MARIANI	MARIANI
GULPLER	GUIMIER
WIBAYLELL	BAYLE
JCHWAFLZER	SCHWARCZER
WLVLRTADJ	VICIAR
BDRREMIEVV	UNREADABLE
LJLSULLLELRHLN	GUILLERHIN
ARNAUD	ARNAVO
MFLLLLELULRTLYVLUUS	FLEURY
HSLAYAWE	LAYANE
WMBELYVLELYUUOIVUJXV	BELVEZE
EVA	EVA
NAKLLLF	MARILIE
MWSMLMDIDVAYUYBTOBQT	LADAWA
MMSMHMUISUIOTYEUYLYLOLY	MUSITELLI
SMAADLI	SAADI
DWMTRMBILMNILOLOBMYBLAJPLYDLV	DI - BIN - LOMBARDI
LLESDELOUP	VISDELOUP
LMSLGAYUXLLLIEIRVLYL	GAUTIER
KOUQQAD	KOURRAD
LEWHO	ELIO
LRISEH	LISEA
CHARLOTTF	CHARLOTTE
INWHFHNMUWIIW	MEHDI
PSFLCNSLU	FLORESCU
LLLMMSTCMLIUFXTYALUUVIU	CHENAL
HLPYIISTE	BAPTISTE
PSPAULINE	PAULINE
HAYATE	MAYATE
SCHWOCRER	SCHOWOERER
LPAVALUWN	LAVAL ROMAN
MMSRWMICVJCIHLLOJJVUL	BECCHIO
PWRDULGLEOLYLLYEJLYDVLV	POUGEOLLE
WWCRACALLYLVLIL	DAGRACA
WWLBMER	HOLLANDER
WCFLLOTT	ELIOTT
MMSRAMLILVAIRODVVVLC	ALLARD
CLEMENTINE	CLEMENTINE
LEZEA	LIZEA
BOURLEAY	BOURGEAY
HLLHAROCI	MAROC
JSLOUZIER	LOUZIER
HHDJIOLHMANE	HADJ-OTHMANE
IWZGFRVFLZLSL	GERVAIS
EIVAN	EVAN
RWENARD	RENARD
MBAUGUUWSTINHW	AUGUSTIN
MWEL	MANEL
LNMSLPFCVQLUVEVRYYYLR	PECQUERY
MSRLVAIS	RIVAS
BWOAIS	BORIS
PLFABZOLIWLS	FABIO
DESLLDUS	DESCLOUS
YSTAGLLLIAFICO	TAGLIAFICO
COLOMBEL	COLOMBEL
NWEERVLNM	MEYER
PSMATLHLILLDE	MATHILDE
LAUVFWZU	LAURENZA
WLLLDNUIJ	GIANNI
SOFLANE	SOFIANE
CYROS	CROS
WEW	PENELOPE
WLLM	NOLAN
LMMRZAH	MYRIAM
DEFFVER	DEFEVER
NFLLKE	MELIKE
MVJENNMVIIAVJN	VIENNOT
LHULLSSLLFK	LAUISSIER
OUBOLS	DU BOIS
AWNTHFAL	ANTHEA
LXSFILELRNIAVNDES	FERNANDES
WEBHWNWLUEIM	EMMELINE
PLLVILSIIISMHEL	LUIS-ISMAEL
LLLND	ELINA
DACUSTA	DA COSTA
MMSTFVQLVSJCHLDERLUJR	FISCHER
JLIEU	MATTHIEU
LDWJMCDUNL	MARDUN
LASSAGNE	LASSAGNE
LWBUCWSWENWI	LUCIE
LWLSLLJLCALSIL	LUCAS
GALJAFRE	GALVAIRE
ANDKTEUX	ANDRIEUX
WLHALLYS	MAILYS
MMSTMWOIVAITULJJN	NOA
CHFBLQOL	CABROL
SMLGWORL	SIGNORI
APPASSAHY	APPASSAMY
WYUJFHLD	MOUJAHID
RMRANDLILY	BRANDILY
TRLSTAN	TRISTAN
WWHU	BOCHU
CHARTON	CHARTON
GASSAYE	GASSAYE
MSZURABLANLI	ZURABIANI
MSWINNOBNIW	SIMON
POWSE	ROUSSE
PSTITUWS	THOMAS
ASGLPLFLREI	GALFRE
WSCANELLEL	CANELLE
WWFINEVVILVVLI	LAFITTE
CAMLLE	CAMILLE
WSHAWON	MANON
LMMSRSMIIXUTVLLLAYN	SIX
HMSLALVVESLLLYL	ALVES
GAWIER	GAUTIER
LUUAIL	LOVAIL
UELACOUR	DELACOUR
WJANAE	ANAE
BWOURGFOIIY	BOURGEOIS
FORIRIE	FORTRIE
LMMIRNFALTVHVTJXNFULVN	FATHANE
ADRIEN	ADRIEN
PLCIHAIPIEALILC	CHAPELLE
CUELAHAT	CHELAMAT
PLSIBELNIJIAIMILINLIWLL	BENJAMIN
UILLLE	CAILLE
STEPHAW	STEPHAN
ALEXLIS	ALEXIS
ELIA	ELIQ
MSANTOINF	ANTOINE
WATHAN	NATHAN
MLAHOUIE	LAHOUVE
DHIXNIN	DHINNIN
VIONAUD	VIGNAUD
JWWULMIWETTEW	JULIETTE
LECOUCAN	LECOULAN
MMSMNMAIVVJETYLSJJN	NAVET
FOMR	FORSTER
WSWELNWWNM	SELEN
KILLLFH	WILLIAM
PSJVLFS	JULES
WMFMWRHSFUQLHJODVJDUYL	CHERNOV
JCNHTHHW	JONATHAN
LPJFLORISL	FLORIS
NARIFLLA	MARIELLA
AADERFAHMHNL	ABDERRAHMANE
PSNUHELMLIE	NOHEMIE
RUSSMANNI	RUSSMANN
LMMIIE	BRICE
MSSHIARILADH	HARAJ
SOLAZ	SOLAL
CHN	CAEN
MBAI	RABAI
AWGRATLINALLLLL	AGRATINA
OHAAESSINN	OHANESSIAN
UPTOUAN	TITOUAN
LIEA	LEA
NATHILDE	MATHILDE
LIWSLBEALULVWLULVINTL	BEAUDOVIN
KERYAN	KERYAN
VWLLPLDLINLYWIUVN	SARDIN
BIZHEVA	BIZHEVA
LMMSMVMLIUAYLDTLNFZSBW	VLALADE
GUERRLER	GUERRIER
THEKOW	THERON
MIHVBO	HUGU
GMULILLAVYELT	GUILLAUME
WSLOCMAH	LOOMAN
MARJOALE	MARJOAIE
LWLCAVALLER	CAVALIER
POHUTAAI	MOKKTARI
HBAFGOT	MARGOT
QWISL	RISS
WSMISHA	MISHA
PSROXANNE	ROXANNE
CLWHUE	CHLOE
BWELLESVILLLLLL	BELLES
PLLOUIANM	LOU-ANNE
UQTAFN	CHATAIN
MVIYWVLAVVJLUDWC	GUAY
AWWQUELAXVLL	ROCQUELAY
LECLWREC	LECLOIREL
FLRONEILLLLL	ROMET
DEBOISSE	DE BOISSE
JUANFY	JOANNY
BTLNLLGIW	TING
NATHAN	NATHAN
THIBALUD	THIBAUD
TWASLLYLLVL	TAS
PSLEALULLNILELR	LESAULNIER
DUNOULGN	DUMOULIN
ARMFL	ARMEL
GMWAUNTWHIERNM	GAUTHIER
LLPSLISAILHHI	LISA
YERLICHRLZELOA	YERI-CHRIZELDA
HWVILN	MARVIN
HMSLKALLILLSVLVVLL	KALIS
WYSHA	SASHA
NAUD	MAUD
WSILLAN	ELLAN
WSLOE	ZOE
CYANEEI	CYANEE
EHARGIN	CHARRIN
VELASCO	VELASCO
LLMSUIWI	NADIR
MATHIEU	MATHIEU
SMWAHNUWELHM	SAMUEL
MDEVLSMSVLLLLLLI	DE VISMES
PZLHOMELR	LHOMEER
CAPHLLLE	CAMILLE
ALLEX	ALEX
FWRESSEL	FRESSE
PWWAUULUWILH	PAUL
JOAN	JOAN
MWCW	BACHS
WMSPMJRIIIUYJIILLV	ROT
WSJJALINE	ISALINE
SELWYEN	SELMEN
MBLIVET	BLIVET
FWSBERHAB	BERHAB
WIFLOUEN	ELOVEN
AMSTIC	ASTIC
PSLUKAS	LUKAS
PSCHARLES	CHARLES
NLICE	ALICE
MWOOMWLWTLILLENM	DOMITILLE
MELCHENLELLLV	CHENE
JMSLFLBTLHLALNLL	LE BIHAN
AMSXSBLLERLALYI	RIBERA
SOUVTUHVOUG	SOUNTHAUONG
LMWHAHIWWFIM	CHAIMA
HATHILDE	MATHILDE
CWMHAMRWIOTYECW	CHARLOTTE
LLPLSLLIOUILLSALIIIIWIU	LOUISA
PIILMALRLIIENILINWIW	MARIE
WMIMMSUIVCHVJLJJJLJ	SUCH
GALLAIJ	GALLAI
WOREYSSE	BREYSSE
DCNDT	DINDTL
JUSTJNE	JUSTINE
PAUL	PAUL
MNHEO	MATHEO
LPIELLISALL	ELISA
PSMUL	PAUL
EMILE	EMILE
WDURUPTVLVNYLR	DURUPT
LMSFERYAL	FERYAL
VWLWLWLYL	VILLETTE
SCARPARI	SCARPARI
WLEWU	VICENTE
MCWEDHRWLCAM	CEDRIC
BPILLET	BAILLET
WLADRLIEN	ADRIEN
NWSCHCVYETL	CHOUYET
ETHAN	ETHAN
NSCHEL	NICHEL
MMSPHMULZTJDJDTJYI	HUET
HIMILUBERTL	HUBERT
MMSMNMIZNVODLYIDDJEL	DINOU
HNWMNMIWANNEAM	MARIANNE
HELORA	HELORA
DAMJN	MARTIN
FNLALWNO	TRADO
KARL	KARL
PARENT	PARENT
SLWSLDUIHLONLCEAU	DUMONCEAU
WWWLMLWLUETTWE	GUILLEMETTE
JFUUON	JEUDON
HPATTHILDE	MATHILDE
WPLGUTLLLL	PIGUET
ALNAIUIIW	ANAIS
ALUIWC	ALHINO
NMOCQUPRTLLLLL	MOCQURRT
THLDAVT	THIBAUT
UMWME	VALETTE
LYWATHEW	MATHEW
ELPLISC	ELISE
WPWIEWRWPENM	PIERRE
HWWSVLILNNNN	SIABAS
ILEMENT	CLEMENT
LAMJBESLTLALOULI	BESTAOUI
HHWMW	MARCOS DE LIMA
CLWIELJLLALHLH	CELIA
HUHBKRT	HUMBERT
AKBABA	AKBABA
LWIRAYNA	RAYNA
LMSLDEGVVUIENIIESNLL	DEGUINES
JAEN	JAEN
DELETRE	DELETRE
NMWEHNDWIIH	MEHDI
WSVALENTIN	VALENTIN
SYALONE	SALOME
WRYMARCZYYXILLILLI	RYMANCZYK
MATEU	MATEO
MWWORGZNNM	MORGAN
MSLILIAN	LILIAN
DELAPORTALLERE	DE LAPORTALIERE
DEGALLIC	LEGALLIC
DUPOUXIIRATFGNER	DUROUX--RATIGNER
NWLDENANVDLLL	DENAND
HANHFH	HANNNAH
NEUUM	MEZOUAD
YANNISII	YANNIS
HFLOIRREOTNW	FLORENT
SELCNEUR	SEIGNEUR
GMWNLLLLLVL	GUYOT
HAELLE	MAELLE
WSALECIA	ALICIA
WSHANON	MANON
PSNFLWE	MELODIE
PSEGELE	EGELE
LMMSTMVALRLYUINVULON	MARY
LPWLMMTICVHTEIILTYNYIJ	MICHEL
PSEVDNN	EVANN
HMWNWE	HONNORE
MSFWLLTLTLELNLPLELLU	WATTELLE
YANJS	YANIS
PIISJONADHFANLHONMIIW	JADE
PZMAIWENN	MAIWENN
IYWRF	ISAURE
YVDNTNI	JOANINA
SOULLINOEAS	SOLINGEAS
ALEXANDXF	ALEXANDRE
KENTLN	KENTIN
UANC	WANG
AWTIWZALVLLL	ATIENZA
WCLWLRLLELL	NOLLET
PFTLTJEFN	PETITJEAN
HAXCGHU	MARCEAU
VLOLETTE	VIOLETTE
IWLLCRLULVELLLILLLLLERI	CRUVEILLER
LPLSCIAINLIILILIEIINMIAM	CAMILLE
YWSPUSLSWLELLULLV	BUSINELLI
MBIN	ROBIN
NUHH	NOAH
NAFHF	MAGNE
ZAUNIER	SAUNIER
HMHALDOVNVLVLLL	KHALDOUN
HIWHABNFWEHIH	MARIE
WLNAINA	MAINA
MAHAUT	MAHAUT
FLFTTFDILLI	ETTADILI
HWNHEFM	BENCHEIKH
JEWNEY	JEANNEY
WWDNL	SUMTITH
KEYLSER	KEYSER
SCANDER	SCANDER
LOZES	LOZES
CLARA	CLARA
QUFNNEHEN	QUENNEHEN
PLLMLIAXALIMIIIIHWLW	MAXIM
IWSBOUYQLLUELTL	BOUQUET
IMSLOSTVEVJNLVVIY	OSTER
HWUWI	HUGO
PSANELU	AMELIE
IWHHHTNWWWIW	MATEO
NDRENVILLLE	MORENVILLE
DMIGJBLOFDJR	GIRAPDI
HARWAN	MARWAN
IMSLDBLATRYTYULFVVI	LABARTHE
IMSSEIYSL	SEYS
WMANAMFWSNW	ANAIS
PONS	PONS
RWQVLERELLLLVL	RIVIERE
JULLANHE	JULIANNE
CLNDY	CINDY
NOE	NOE
ELIWM	ELINOR
PISARAH	SARAM
MMLTCRYLVLIRVAUUTUYJN	CHIRAT
CLMLARA	CLARA
WSDLWAH	DINAH
DWORLONVYVILLLV	DORION
WFHLVLLLLLL	AHIHRI
WIZEINIERNLJTIAN	JEAN-ERMESTIAN
LWCNILFYNFBA	DIEYNEBA
PSLLANLGLELVLIINXYL	LANGEVIN
IWSLDUWLLLLLPLLL	DUBEL
PLAN	PLAN
AGHTHE	AGATHE
IPFRLRIH	PERRIN
MSSCHOLLTESL	SCHOLTES
TOH	TOM
LOLC	LOIC
LUKAS	LUKAS
WWMMELMUMNBSBX	COME
MMSRGWRIEUJWELJLOJTTOU	GRENEROT
WIOSLGR	OSCAR
BMLASCOLILLLLVL	BLASCO
WFORTIFRLLLVVL	FORTIER
JRJGENT	PRIGENT
WWWWMWNELW	REDWANE
MTIHRALLVLTFLNJPYTL	MALLEM
PSTIRIWIILH	TROTTER
WRSFMMALVUCLVETVVVVV	MAUGET
ALLMKRW	AKRAM
ELOI	ELOI
SAUTIANA	SANTIANA
GLLLIGIBLLLANWR	GILLI - BELLANGER
NLUYI	THEO
MSOUTIFLLLLL	SOUTIF
QRAUD	GIRAUD
PAUC	PAUL
PSLCHALULSLSLYLVLL	CHAUSSY
PLLFIIIOLNIAILHIWIW	FIONA
VWIWTLLL	VINCENT
MAIEROT	MAIGROT
RIEESE	REESE
PSAFATHE	AGATHE
LMSENNARLL	ENNAM
ALFTAAD	TETARD
WLOPFZLYVLLLVYL	LOPEZ
WIILHYJ	ENZO
RZTSCH	RITSCH
AOHADDEB	MOHADDEB
WSDLLX	ALIX
EBVAN	EVAN
WLNDTHAN	NATHAN
DEPAEPF	DEPAEPE
DJADI	DJADI
LPSMNEL	MAEL
NWWAUMRWFNEINW	HAURINE
ROSNIH	ROSIAN
ENGELNANN	ENGELMANN
HAYEO	MATTEO
WWLMDMNSRUUSNYDTWNHLDLL	UNREADABLE
CARLA	CARLA
LENA	LENA
SYAW	SAN
BADDUT	BARBUT
MMSTMCOIUVRHDYUEAOJUOJ	COURDEAU
MWWAEMLWOW	MAEL
MSPERVLKVLHLSLLLY	PERKINS
GABRLEL	GABRIEL
ELWAN	EWAN
FERRAND	FERRAND
ILMLONA	ILONA
MWLUUHWEHW	LUCIE
CNLLL	CHILE
WSLELLGVVRSLLO	LE BARS
CULLALNE	GUILAINE
WBOESNERLVNLLVLL	BOEGNER
LEFEVVRE	LEFENUURE
WWNHMJWSKNW	MATISSE
LOPES	LOPES
HERVE	HERVE
MWEVANNWIM	EVAN
WSMWLLWVLVYLL	MORGEN
GLCUUET	GASQUET
NAUSUAA	NAUSICAA
MWROSNEWNW	ROSE
IWYABLAFLOFYVJUHUYV	CABALO
LUULISE	LOUISE
MSJWNNF	JEANNE
MSTHLKALD	THIBAUR
VLES	JULES
MAEGA	MARGOT
VYAISSIEAE	VAISSIEAE
WIXEL	AXEL
EW	EMMA
YANN	YANN
LALIE	LALIE
PSLHIW	LISA
HCLLA	MELIA
ALDRIEN	ADRIEN
SIDTZHE	SATINE
DPUPWT	DUPONT
WLPHILIPPIINELL	PHILIPPINE
WSELOISE	ELOISE
LCULSF	LOUISE
WSMNLFRLOLYLLLL	MONFROY
BENEZRA	BENEZRA
WMISSKTALFRWMANJFUALL	STEPHANE
WMLMWLLOSOHLGSJISBLLLRIUJLLL	FREIRA-LAMPALO
LPSTLECPHDNE	THEOPHANE
WSMATTHIEU	MATTHIEW
MWZILELL	BAZILE
VARO	VARD
MSLBODVALJRTULVYI	BODART
CLFA	CELIA
LYLISIHLEHIDILLHLLNWIIM	HEHDI
MSYALSAR	YASAR
LPLISALMREILLEEOHNLNWIIM	AMELIE
AWFWSON	ANDANSON
LASTIEH	BASTIEN
PSHELLSSA	MELISSA
WJCLFRISSE	CLARISSE
REML	REMI
WWVVLLLVJN	DARSLAM
LROCXEK	CROCHET
DMASJONULLIK	DASSONVILLE
GONCALVES	GONCALVES
PSHAXEWEE	MAXENEE
LMAFOURCALDEVYITPOLRLTLL	LAFOURCADE-PORT
MTLPLELVCYOMVMTEJI	LECOMTE
MYVSLSAMEZFI	MOUSSA
LISA	LISA
DELLESTANG	DEVESTANG
MAXANCCV	MAXANCE
DENPURE	DEMPURE
QIENTLN	QUENTIN
AUZELY	AUZELY
EMWLSWAWHM	ELSA
PLSBLAIFITIIISTEIIWIW	BAPTISTE
WSMFLANQF	MELANIE
MATHLLDE	MATHILDE
ROBIN	ROBIN
LBCCHASNGNW	CHASTAGNOL
LIIS	MAELLE
WMILMARTLRLLLIL	WILMART
UWSBOULTLOTLL	BOUTOT
PLLSALTOVINENWIW	ANTOINE
TULES	JULES
WSEWY	EDDY
QLWIILWL	SHIREL
HOUAHEDALI	MOHAMEDALI
JUSTIN	JUSTIN
WIXABF	XABI
LARDEVR	LARDEUR
KWLLATJSLLLLLL	KAIS
DELLS	DENIS
AKLES	ARLES
MMSRDMELLVVOMVLLELRBIU	DELOMIER
HALO	MALO
EINZO	ENZO
TMLSST	TISSET
MMSPLVELVTYIHVIETCIVN	LE THIEC
AMANDFNE	AMANDINE
WSCAMLLE	CAMILLE
PSLYNE	LYNE
WSHNNON	HANON
SANW	SANAA
KZLLLAS	NICOLAS
BRIAND	BRIAND
NORGANE	MORGANE
PSESTHER	ESTHER
WLEBLOVHFELLVEICLLILDL	LEBOUHELLEC
PERES	PERES
WSNHRTELEMY	BARTELEMY
GOFFLW	GOFFIN
MLGAETAN	GAETAN
CHANTEUR	CHANTEUR
WWWWETVILNLUN	WERNET
LOULISE	LOUISE
RPOWDEL	ROBIDEL
VLIENE	JULIETTE
CLARSH	CLARISSE
RWOUSWUVIUVLVLL	ROUSSEAU
WSCECILLILAL	CECILIA
IWCVENDELELYLYLL	VENDRELY
HFLIE	HELIE
WMSPIWEIXLLOIYULVVJJ	ZENOU
XMAWEAHDVUJDAUFLVPIEY	VANDECANDELAERE
VIBHAWNWWNEIW	VALENTINE
PISOLYNE	SOLINE
WWSTLEN	BASTIEN
DLLSYLEEW	AISLEEN
XWLLNLLELZLEVLYLCUWYJNL	KNEZEVIC
VIIBGLILC	VIRGILE
BANRIEL	GABRIEL
LWLSCLALEHLENJ	CLEMENT
JEANTFT	JEANTET
WQNUFNF	BENNANI
MSLBALLDLOLVIFVVIL	BALDOVI
WSHANA	SHANA
ZIZARD	ZIZARD
PMWTEHWILOUHM	PIERRE-LOU
WNJANIIN	BENJAMIN
DMLRIIEHNAIRIDIIILL	RENARD
DWELECLOTXLLLLLL	DELECROIX
LPSANLNABELLLEH	ANNABELLE
MWREK	KUBEREK
MMSTGMOLBVRULOLNLLLW	GOBRON
HMBEZNLWPHHM	KAZIAH
PAUL	PAUL
MMCPMBEIGVOINJUUJVU	BEGON
FWSDRISSLI	DRISSI
OLLVA	OLIVA
MLIHALCEA	MIHALCEA
LPWAUL	PAUL
NFRHLLLON	MERMILLON
SERLA	SEFIR
MMLUME	DELORME
MSLEA	LEA
CREWW	CREUSOT
LYAN	LYAM
EM	EMMA
WMIDWDSROIZIBLOOGBNLL	PASCAL
MSALARLC	ALARIC
DWENNFAVINLILLLLL	DENNEQUIN
MJBASTIEN	BASTIEN
MMLMMCCIUVHVTLTLDDYU	SCHMTT
WMBOLSVYYLLURI	DUBOIS
WSLWVBECCVHLTVLL	LYBRECHT
BWHRBEVVVYYYVNI	BARBE
HWCHLLOLELL	CHLOE
PWMOFMLALWZNIUYJNWJLI	POPLAIN
EMWEEMNWANW	ERENA
THWAS	THOMAS
BESAIN	BESAIN
SUW	SUUA
LMMSYWDWIUWUUOL	DAUMONT
MSANNEILUCIE	ANNE- LUCIE
NARQILS	MARQUIS
WSNOROHAN	MORGHAN
DESSFD	DESSED
PSKARCLLLINE	PARCELINE
COKA	GORA
DMFAWVRIE	DEBOUVRIE
RENAULTL	RENAULT
HWMWLDNYMVLIUIUJD	HARDY
YILZJLUOLLILECHHJNMIIW	JULIE
TWLFIWLLNYSTYVILLLLL	TIMENTIT
FREHLOND	FREHOND
BRULE	BRULE
WSTOM	TOM
WAUDLSSOLLILLLL	AUDISSO
MAYRTHHWURNW	ARTHUR
MMSRPMOIUNVCOHEVULODL	PONCHEL
AWUPELIM	AURELIEN
BROSSE	BROSSE
CWJF	EVE
GENECHESL	GENECHESI
CORREGC	CORREGE
PIAWDOUL	AMADOU
PIVTE	PLIUTE
LMLLORALJNE	LORALINE
BLPFMILLE	BERTILLE
MLLQUYIVLLVOLULLDVY	GUILLOUD
ANTOINE	ANTOINE
PLM	PERES
WBNMMIWNENW	MAXIME
OREVIEKE	BREVIERE
AMLBPUXL	ALBQUN
DARBLADE	DARBLADE
POGODALLA	POGODALLA
MMSMMGZIUFJRYERLYYJN	GERBER
WMLYJVOLHLULLYJL	DAH
XUWI	RUBEN
LOLLLAL	LOLA
SOLENE	SOLENE
JWSLDFHLOLUVLVLAVUSL	DEMOULIAS
VRDMF	COMTE
HLUTLZ	LUTZ
DUADCLEL	OUADFEL
MWWNWNW	THOMAS
PSLOLLLLOT	IOLLOT
LWEWIHVLLLLLN	LE LOCH
LUCOS	LUCOS
WMSMUMACUDJODUZNNTN	KADOUR
TERWUNDES	FERNANDES
IMMSPIVNLAYRYRTVANIIU	INARRA
LISA	LISA
TLIFLFENLLLL	TIFFEN
WSLLATHUILLERE	LATHUILLERE
WSSALSS	DESSALLES
WRIBESLLRILW	RIBES
MMLENNNWLNW	LENNY
LWWWMWWAJFL	CLUZKI
KAFUENTE	LAFUENTE
EMMDI	EMMA
DWZPLANEFLLLIFS	PLANEILES
MAUD	MAUD
SAPTLSTL	BAPTISTE
HMLLSTLKLANLILLVLVI	KAN
LEROUX	LE ROUX
LOLUYLSON	LOUISON
BKULE	BRULE
NAEL	MAEL
PSALFXANDRE	ALEXANDRE
PLHLALHLIALVTLI	MAHAUT
MLJADAULT	JADAULT
JNBZRIL	JRABIKI
MSSLIMON	SIMON
ANASTASIA	ANASTASIA
VLOLLEAV	VIOLLEAU
ANELIE	AMELIE
LEDFL	LEBEL
BWWOMMAWINW	ROMAIN
ESTRUCH	ESTRUCH
CHLOE	CHLOE
DHELFOSSE	DELFOSSE
PJCLARLALJ	CLARA
CRD	CROS
SMWK	SIMSEK
PSSOLENNE	SOLENNE
AMWWINTWAIWI	ANITA
HL	ZOMERAND
WLGAETAN	GAETAN
JMWUOMCWNW	DUOC
MMSRJMWLYYINLNLLJILI	JACINTO
MLLLFBLLELYLLAVNLWLLPL	BELLANGER
TWBW	THIEBAUT
CHLOE	CHLOE
WSAFHY	BENJY
LPSCHARLCTTE	CHARLOTTE
WLLBOVDYILJLVOLTVLV	BOUILLOT
UWLUHEIY	AUDREY
BWCRAHLALLVFL	BERAHIA
NWIUBRUH	LEBRUN
AUDIN	AUDIN
PCJHZLVIE	CAMILLE
LPSNICOLAS	NICOLAS
LWLTCNLLRN	DIAS ITARTINS
PJSHEJLLLINLALIINWIW	MELINA
LWSCECIZE	CECILE
IMSNAGNUNHOUN	MAGNONHOUN
WSLFANDPFL	LEANDRE
EWLAWLLLLLILL	ELARD
DOUYIELLIWC	DOURRELIGNE
AILEXIS	ALEXIS
PSJVLLILE	JULIE
WYLINE	MAYLINE
PLNATHAN	NATHAN
KY	KY
PAGNEUX	PAGNEUX
LLEREFLN	CLERENTIN
CHLOE	CHLOE
WSCHLOE	CHLOE
PLAIDRYLJ	AORIEN
BUTERY	BUTERY
PERRINE	PERRINE
PSAUGUSTLN	AUGUSTIN
PERRIER	PERRIER
GWWORMAWYANM	SORAYA
TWHOLLLLLYVLL	THOLL
GALLSSALRE	GALISSAIRE
BYOLLWO	BOLLARO
FNW	ENZO
EYAN	EVAN
MLXALL	MIXAIL
MWLOTNCWNW	LOIC
LPSOCTAVE	OCTAVE
MWFNSKIRWBUJ	BOINSKI-DOBUS
DWERRONNOLLLIL	PERRONNO
MWRAXNEWNCEHW	MAXENCE
WMLPRMOIUYETITVJCIW	BOYET
THEO	THEO
LMWSMDMCSRUNJINZSLW	PEGO
MSLEO	LEO
MSVALYEL	VAYE
YAXLLW	WAXIN
HWMFHYRLYLYUJJLLOIC	HINRY
JCHEFFFR	SCHEFFER
MMSMMALITVYLHAJHLUJNYLUNIL	RIT HAMMOUN
WCLOT	RACLOT
SOLLNE	SOLINE
HFMLN	MARTIN
UMIHU	CAHU
WBALDUCCLVYLLLLLL	BALDUCCI
JASON	JASON
QLFWEM	COUVERT
PREVAT	PREVOT
HFCHF	FLECHE
LMEA	LEA
YSBLAUDRLIY	BAUDRY
AASPARD	GASPARD
LMMSRFMELLOVRSHJYVN	FIORI
DUDQDFMTNULILLE	OUDOTDEDAINVILLE
WLLRUZCJ	LOUIS
PCHATHEO	MATHEO
HFRUE	HEVRE
REXFLLA	REXELLA
PLROMASN	ROMAIN
PSBENOIT	BENOIT
HATIHLIAS	MATTHIAS
MPSTFMRLVANOYCOVVIOSVV	FRANCOIS
LEMHSSOU	LEMASSON
WSLFO	LEO
LMSHOCQWEKE	HOCQUETTE
BARTHHE	BARTHEYE
WMSRMKAIUFIPFJUSJUBL	KAPPES
REBEL	REBEL
AVLFAWE	ALGANE
PIELISF	ELISE
GENTFL	GENTIL
YPLLAN	YLIAN
VBENZEYYO	BENZETGO
RWBEMHIWNW	REMI
NMWMNWHM	TOM
LPIIIQNUILHNOIENIWHLNWIIW	QUINTEN
LWEWVYIVLLUI	LE COQ
SUZU	SUZY
WWWLNWWWNW	WILLIAM
MCYOUNESS	YOUNESS
KWRLSTEN	KRISTEN
LAURFNA	LAURINA
I	N
DIRONWEAU	PIRONNEAU
KAHIHSKZ	KAMINSKI
PHHRLELLOU	MARIE-LOU
OYEGAROLN	OEGARDIN
NMSLTOLFFLILRERVILL	TOFFIER
LLOUJSLL	LOUIS
LPSMARGOI	MARGOT
MCWLENHWENCEHM	CLEMENCE
RHLSON	RAISON
WWNAUNWIW	MALO
LWSBOUTLLLLOLNL	BOUTILLOT
CAUDYCE	CANDICE
DIERRE	PIERRE
MWELZNNWANM	ELINA
ERDFH	ERDEM
WIYFKAN	YAKSAN
PSROHAN	ROMAN
WSLDARYZYAICVLUVV	DARZAC
JHZLRLOUS	AMBELOUIS
MMSRDVOLUVRYVBOWNLUL	BOURBON
LLWIUCLUFLLLLL	LUCIE
IMJUEQLSGKRWLRY	WEISGERBER
TSLHJFR	TSCHUPP
HERMET	HERMET
MODNO	MORINO
AVTOINE	ANTOINE
CHATAQGNW	CHATAIGNER
FAOILDFVAL	FROIDEVAL
TJLBCFGHYEN	TIBERGHIEN
NIWION	MILLION
MBYARHIIWEHW	MARIE
PSWHSA	WENSSA
BLRLCLK	BIRICIK
BBNLSK	BAPTISTE
PLWLLTLIMLLKLEI	ANCZYKOWSKI
TLOUAS	THOMAS
AWSSSON	POISSON
WSLEQ	LEA
EYTAN	EYTAN
MLETUHELIN	LE TUMELIN
NEWARD	MENARD
XPMPQD	KHEPPAD
WLLECORRE	LE CORRE
MLLJARLWLLNLLVLL	JARDON
LOUESF	LOUISE
UVANNA	YVANNA
PHHM	PHAM
PLEIILOLLJSIEIIILWI	ELOISE
GWCHULIRLLLL	SCHULER
BMOLEY	BOLEY
PLMHA	SACHA
WMSMMDUITUCERTUTURYEJTIJ	DUTERTRE
WLLILTDLLUVLELITVVVYL	DUVET
PAUL	PAUL
MMSPWMIVCQJVJJDL	DARCQ
WMA	SAMIR
ILNRN	IIARA
LPSLEALHIL	LEA
PSLOANN	LOANN
VAUNTW	VALENTIN
PLSENGUEHARD	ENGUEHARD
PIISLURWILNHIANMILW	LAURA
OASRIEL	GABRIEL
DWSDESGLRANGELSL	DESGRANGES
RWOUSSEAULLLLLVLV	ROUSSEAU
HSWHESLLL	GOMES
LWAMLOLSLLLLLVVL	LANGLOIS
PLFAUVALRQUE	FAUVARQUE
IBLLANA	ILLANA
PLCOLLOMBET	COLLOMBET
WSNN	NOA
MSWYRWFWLNM	GYRIL
BWLFNOLWLIYNLIILIXLL	BROUTIN
MMMHENLWYSIM	MAELYS
PSALOYS	ALOYS
RAPHAFL	RAPHAEL
DATILLET	BATILLET
WMSMNMOIEVLJLKJJVL	NOEL
LON	ION
WMBANMWEOW	MATHEO
CATEILSVE	CATEIGNE
BASTLCN	BASTIEN
DESLIAS	DESLIAS
AUNRE	AURORE
ZQBIBL	ZERBIB
MEPUUG	MERZOUG
JSBOHOLI	BONO
HARLIAURELE	MARI AURELE
WMNLHNCKEVRIVALDAU	VANLANCKER
VWZDUVAL	DUVAL
GLOLIRE	GLOIRE
HWMARMYUMHUDWAMCJTVA	MARINHO DA COSTA
HANON	MANON
FWLLOREAN	FLORIAN
LUCIF	LUCIE
JWILPLVELTLLYLVU	PIVET
JWWUSMTWINECW	JUSTINE
IBWNWNWIW	MARIN
HARTLN	HARTIN
HWAILHYS	MATHYS
WSFLZSF	ELISE
LWSFNGUERRWD	ENGUERRANO
WSLLNA	LINA
WLAYMERFC	AYMERIC
SOLENF	SOLEN
WSDANJLOIXLL	DANJOIN
KOBLLLBRD	ROBILLARD
SMLALIAKIEILII	LAKEL
WCELENA	CELENA
WWJORNDWANSNW	JORDANS
EIWHNWNHWIIW	EMMA
WLVLLCTORINE	VICTORINE
THEO	THEO
ALBM	ALBAN
PSGILBCRT	GILBERT
LWAAFILLVLVLL	LARFI
WSWALLDL	WALID
MMSTGRELVNTVVEVUVILVHN	GENTEUIL
VHLFYLN	VALENTIN
PASCAUN	PASCUAUD
IWLDASLLVACNETANC	DASILVACRETANG
FZPLLSTF	BAPTISTE
FFFVN	AARON
ALLACHC	ALLACHE
IMSLRLOSLLLLLLL	RIOS
MSFFWFN	ERWAN
MMITCMOIVJLAVUVUJL	COSTA
WLLFOULLVRLNLYIVL	POUILLY
SLLOHYCN	SIMON
PSSOULRICLKLLLL	SOURICE
HLLSLDAVWPERLLLL	GARNIER
MILECHENAOELC	LE CHENADE
WWFFAUXVLRLYL	GOFFAUX
CLOUFT	CLOVET
FRANYQZS	FRANCOIS
NWSSTOLRLCHVLLIL	STORCHI
MLVLFHLLACYHIUVLVLUL	MACHOT
YWWMWRNW	SYWAR
BONNET	BONNET
ZAUSNU	AUDRY
WWABNFWUSIM	MARIUS
WCHIANFHRENLIIH	CHARLENE
LLWEANWO	LEANDRO
WSLOLA	LOLA
WSWSHLIERLLI	GASNIER
HATHEC	MATHEO
NAXFNCE	MAXENCE
STEFXN	STEFAN
KLLLAW	KILIAN
HSSALDALTVLIEB	SADATIER
GFHNOMOLCIW	GRANDMOUGIN
CORFULLIN	CORENTIN
PSROY	ROY
MUTYFO	MATHEO
SALABERRY	SALABERRY
TANGUY	TANGUQ
UMMSIPLWLYKNLMW	KASPRZAK
ORANGE	ORANGE
OMWCUHUNEHIIM	OCEANE
BOKHTARI	MOKHTARI
PWRUVOST	PRUVOST
SABOUREAU	SABOUREAU
LOGTTE	LORETTE
LOPFS	LOPES
WILADLLLF	CAMILLE
WZLANLOJ	GLANIOS
REBAILNE	REBAINE
MATHIS	MATHIS
IWITEFXEIRAL	TEIXEIRA
MMSPMLAIVLVATLLVLJV	LALA
PSOPEBK	OPHELIE
ELLSIALDE	ELISSALDE
WSPHILIPPINE	PHILIPPINE
MLSLNMLLELYL	DUMEY
HLMMILDA	MATILDA
HBAX	ADAM
WSTAWNZDL	TAWHID
CWWERF	COMMERE
JEANHE	JEANNE
WSMDTISSE	MATISSE
MVWSNNCULIHNTIM	VINCENT
CWLCTLILH	CLOTILDE
NWATHEO	MATHEO
TATIANA	TATIANA
BWURWU	BUREAU
GWWWNOWWNW	GEVORG
LMSSICLILLIALLNUL	SICILIANO
IWICANLALRALLL	CANARA
HWAUCHECORNEL	HAUCHECORNE
RLBEN	RUBEN
PAUL	PAUL
NWLGRALNF	MIGRAINE
LLPSLUCLASUEDAR	LUCAS DE BAR
NATNZS	MATHIS
WLNICCW	MASCHA
PLCUVESLLWVNLLLL	GUESDON
PSLXARLLVNAYLLLL	HARLAY
FIRA	PIRA
LPSCDLBKIFLL	GABRIEL
DWIHN	DORIAN
IWSLSHOLWITLLVVL	DHONDT
ALEXHNDRE	ALEXANDRE
NLCOLAS	NICOLAS
PIMARLOS	MARIOS
HALLLE	MAELLE
IAWHLENXULSBIW	ALEXIS
NCNTOUX	MONTOUX
LEA	LEA
EHHA	EMMA
ZIAH	LIAN
MMSRMCFLWYVTTLBJJV	CICUTTA
HUATAVT	HURTAUT
LWAUTLERLLLLL	LAUTIER
LIMSWIEZLBLLCKILL	WIERBICKI
BOUDRIFAU	BOURRIEAU
AMHELN	AMELIE
CWHAMIIER	CHARRIER
PHLLENLLILSNANIIHIWW	ELISA
WIALEXEA	ALEXIA
CLARA	CLARA
ZWAWLIL	ZURAWIEZ
WWWLLILYILL	RODA
BRLNGER	BRINGER
LEFEWRE	LEFEBVRE
WILEDUIN	LE DUIN
LEGER	LEGER
NATRAS	MATRAS
WMWOACWANEHM	MORGANE
LWAINLLLLLL	LAINC
XRLISTLIAN	KRISTIAN
LFON	LEON
XWOSSFVLLYLVIL	ROSSI
VWMELWCOLYKUEVDLIUVLI	WELCOMME
MLWUCMWNW	LUC
HARLE	MARIE
WSEYTEBDW	ESTEBAN
RPLONOOT	RINBOT
LORENZO	LORENZO
JMWUSNTWLNEHW	SUSTINE
HENUCRY	HEMMERY
ALIX	ALIX
PCCLNDY	CINDY
PINOEIL	NOEL
JOURDAIN	JOURDAIN
LWSVLWSHAH	VIBUSHAN
PSROTAIN	RONAIN
RACID	RACITI
MIAURELIEN	AURELIEN
WSCLUHILDE	CLOTHILDE
NIILCLAS	NICOLAS
ZMWWEWNWWLILNENW	GWENDOLINE
HMSTTRALBVUEJYLALL	FABRE
TWEGXEQRALDYLIL	TEIXEIRA
THAIS	THAIS
PLABEVA	NEVA
CDWNCE	CANDICE
LEWLEAU	LEVETEAU
HMSPLCHON	PICHON
MSDWATS	ANAIS
EMHA	EMMA
BADTISTE	BAPTISTE
MWSPMWFLAVVUVUNUNLL	MARY
LMSLAURF	LAURE
MALAYGAUX	MARGAUX
DORIANA	DORIANA
HUPINLAI	POUPINEAU
LLUCYIE	LUCIE
CWHMOYI	CHABOUX
ANDRE	ANDRE
RYAN	RYAN
PSHAHIAH	MARIAH
VLTFLTE	JULIETTE
WSTHONH	THOMAS
LFWLS	LIGGEOIS
LWSMESLLFLL	MESLI
NPLIETTE	JULIETTE
MLALYVEYGLLL	ALVES
PTRIOIXIANIELLIJ	ROXANE
WZAM	ORIAME
WSANNA	ANNA
GHMN	GAUBERT
SOLPYHIE	SOPHIE
WMIULWNSLULJSLINOIZLBBNLL	COUFEON
EHLOE	CHLOE
WSSOPAYA	SORAYA
WIHJILLYC	MAILYS
CORUTLIW	CORENTIN
LMSPMHL	PATRY
SOUAIDIBEMHIOU	SOUAIDI BENKHLOU
PRADELLES	PRADELLES
HUH	LOUH
PSLGULIOTL	GUIOT
REVLLLON	REVILLON
VLCTOF	VICTOR
JWACOBLLLLIL	JACOB
MSAUTLSSLNEFL	AUTISSIER
REML	REMI
ELFXBFDPF	ALEXANDRE
BETHAN	BETHAN
MMSPWMIINVTTEJRVSVJTEJIJN	WINTERSTEIN
IMSIVADOVIICS	IVANOVICS
LPIJEANHWEILLILIII	JEANNE
VERW	VERRO
AXELLE	AXELLE
LLPSAHAHOLS	ANANOS
MMSTMROLUVVMNVLYLVLR	MOUMNI
ULLQEL	GICQUEL
MSHEVISON	NELSON
HAZXEO	HAZZEO
PLADLALUI	ADAM
CHAUHOW	CHAUMONT
SAWK	SARAH
MSMAEWON	MARWAN
WCANOLCEIL	CANDICE
MSSERUVTLL	SEROT
WDFLFINE	MADELEINE
RWACHID	RACHID
FWCESPENCER	FORCE SPENCER
HARCIULYSSE	MARC-ULYSSE
LCWIELJIWFLLLLL	CELINE
PHCCLLETIER	PELLETIER
CHAALOTTE	CHARLOTTE
MWMAHYWWNW	MAYOR
L	nan
NPLIMA	NIMA
MLEBELLEWVLUVLVLL	LE BELLEGO
AMDX	MAX
MMIMCMHIUDTJOTVLJILLLTXNT	CHATOVILLOT
DUBRDIL	DUBREUIL
AUTILUE	ANTOINE
CWMHYMAWAANW	CHIARA
WWCHELLLLLLLLL	MICHEL
HVWICNTLOHRILH	VICTOR
LWEWEPEILYYLIIN	LEQUERE
LYOEN	LYOEN
BRETAGNOLLE	BRETAGNOLLE
SOCE	SOLER
PSLOUIS	LOUIS
MLAMXEO	MATEO
MSLYUYCOLDLVTEUVYL	LACOSTE
ELHHYANUELLE	EMMANUELLE
PSNINON	NINON
BOUCHER	BOUCHER
LIWYLYHMOLSLBLALLHLIJL	MOSBAH
DWLGLAEYIERNLLIL	GEYER
HWWARNIFWNM	MARIE
CWWLENMWEUTHW	CLEMENT
IWLPHILLLIPSLLL	PHILIPS
CUMLLLC	CAMILLE
WYRTRAND	BERTRAND
VFPNF	VERNE
LLLUMCLE	LUCIE
VJJIILILC	CORBEILLE
TWHUHFXLLVLL	THUNIN
LWSFLEA	ELEA
UIEGO	DIEGO
DWSHERVF	HERVE
DHULST	DHULST
IWSNANLINL	MANCINI
DUBADDIN	DUGARDIN
PSFABIW	GABIN
WYHRUGGE	VERBRUGGE
GUSET	GRASSET
LLPSJLULESLFHI	JULES
NLIN	EMIN
PLBOIHPNL	ROHAN
TWHAIS	THAIS
ASPAUL	PAUL
DWWDDEY	BAILLEY
LWSDAUILPLALGLESL	DRU-PAGES
LAMUQORL	AURORE
IWILLELNALLJLAELLLV	LEMAIRE
WSALEXANDRA	ALEXANDRA
PSPAULLHE	PAULINE
SCHNENWUCKEK	SONNENDRUCKER
XOWEWE	HORTENSE
LMMSRUVLYSSLELVLLLL	CASSE
WNUSCR	WINDSOR
EWWLVNLWREIW	ELVIRE
BMONNET	BONNET
MMZYGNWLUIVULLZVIJ	GONZALEZ
AURFLIFN	AURELIEN
MMLYNVLYTLGCIYUVNYGJL	TAZIOUNI
HWSLMAVLRLELYVYIR	MAIRE
WINANON	MANON
PSTHNAC	THOMAS
PSQUEVTLN	QUENTIN
MILFONLE	LEONIE
KERLFL	KERVIL
DAUL	PAUL
NAPINHO	MARINHO
SYLVAIW	SYLVAIN
CMWHWNWLYHM	CHARLY
VEJINEUA	DESIMEUA
LWHAERE	LOTHAIRE
WMLNWISNDYGSNINASDYU	U
OCEONE	OCEANE
PIWRFILOUIS	PIERRE-LOVIS
LFJRLWLEINEIA	ROBERTET
MWWARMIWEILEANW	MARIE-LEA
UBNLTLNII	DAMIENS
LDSKIOIMLILLISUL	KOWALSKI
NAIH	NAIH
MLLLLSFMLLVLMLNEWLINS	DEVARENNES
MLVSLTALLOLULSSLELULLL	ROUSSIN
MHBAEMLWENNNW	MAELENN
LWSDEVAUD	DEVAUD
ELLOT	ELIOT
NLLOPLHAN	NOLHAN
PONCHOW	PONCHON
SALDMOUTOLOU	SAIDMOUTOIOU
LPSLEENA	LEENA
SOPHIA	SOPHIA
ALHEODOKE	THEODORE
SOUIRONI	SOURON
LWIEAMCLLE	CAMILLE
DLDOUH	DIOOUH
LMSLBLLAVUSLSVVOXLLLL	BAUSSON
THEO	THEO
MSPAUL	PAUL
WERMMLI	GHERMAONI
AGLALTLHE	AGATHE
CMWHLHOWEHM	CHLONE
PRLAM	PRIAM
PSOALIGLAZLOW	GALIGAZON
FRANCI	FRANCI
JOULIN	JOULIN
SLALA	BLAIR
SAMH	SARAH
PLCLARA	CLARA
UNI	RESO
SYLVIE	SYLVIE
TMRJULDLNOLYVJUJJUIV	JOURNO
DSCHANTLEUA	CHANTEUR
WLITL	WITT
DUCLERE	DUCLERE
HMFPVWIUNDLONF	MIEPOT VAODON
WWGREMGWOFRENW	GREGOIRE
MMSYARSLSVOLNLIYOVNLVVLL	ASSONION
SOUONA	SOHONA
TWEO	TEO
FMJWXRTVVNVLNLL	FROCHART
LWSLHOEWLLV	HOEN
DFRCE	DARCE
MMSPMMAITVHIIYISVJDL	MATHIS
JSYLLARHP	VIARD
MALAPEL	MALAPEL
HUUU	HUGO
LUKAS	LUKAS
PISALDLHHLLIEANHHIIMIM	ADRIEN
LOVNA	LOUNA
ELHPHA	EMMA
JULLFTTE	JULIETTE
EWWLIMOWTTAM	ELIOTT
UUANG	HUANG
GWEPHYKLVLLLVLL	GIRNYK
LMLVLFLRQLFVFVIHTVTVIELR	LAFFITTE
PLLLELOLI	LEO
WLTLLFC	RAGEOT
WBANL	RAYAN
WSSARAH	SARAH
PIIRREIMARC	PIERRE-MARO
MLLSLYCLLOULLLOLUVRAT	COULOUVRAT
DETCHESSAHAR	DETCHESSAHAR
MSJULLIIWL	JULIEN
CORHON	CORHON
TWRLSTAN	TRISTAN
LLLILIIIN	HANESSHI
TMREBOUX	TREBOUX
WSYAGHIWE	YASMINE
WSKCLNAIN	ROMAIN
LAURE	LAURE
CHAPLOT	CHARLOT
YSBIABIN	BABIN
JWWOAMHWOW	JOAH
AHTOXIN	ANTONIN
MNLHM	FOLASTRE
WNOMAWF	ROMANE
LYFS	LYES
MATYIEUI	MATHIEU
PSNALTHLEU	MATHIEU
LMSFPAULE	FPAVIE
WFRNANOUWILLLILL	FERNANDEZ
BWLZZMUWLLLLLILL	BEZZAOUYA
HWILECOUVFY	LECOUVEY
BARBET	BARBET
RCUSSDU	ROUSSEAU
MLLJLRANYBWVULULLL	RANNOU
NYLJAXL	NIJAKI
MCBOLLLIEIKL	BOLLIER
PSMAXYHE	MAXIME
MRSTCLLOUVRVTILEYAULVL	COURTEAU
LEO	LEO
LFLBVPONT	DUPONT
PLCLOE	CLOE
SLLMOH	SIMON
KMANMDCWD	KANMACHER
TROISPOUX	TROISPOUX
MSSARAH	SARAH
WMLL	STOLL
MMIPWBIIRVRUALBDHJJAJ	BERRABHA
CWWHWMWLENENM	CHARLENE
MMSMMWNIULNDDJCLCIFJAJYLL	BOUBESSFAU
BACEL	BACEL
HOIAS	HOUAS
JENNEK	JENNER
HARIEM	MARIEM
MWALLKILLLL	MALKI
HLCALVETI	CALVET
DAVEWL	DAVENEL
YSHEGOIL	HEGO
VLV	VIU
TAUEVOSSLLAN	TADEVOSSIAN
FAYM	FANNY
PSJULLE	JULIE
WSNAHN	NATHAN
EYWANO	ERWANN
WYHUFWSCW	MATIS
EVA	EVA
DMSLLLVLNLLUF	CLEMENT
NAXLINE	MAXIME
ALLLNN	ALLAN
LWSFRIC	ERIC
PSHHIAIIHIEIULI	HATHIEU
MSLVOLIILULFI	VOCCARI
GEGES	GEGES
MJMATHLIAS	MATTHIAS
LLPILLULCJLELLLLJ	LUCIC
URJCCAU	BRICEAU
WWL	THIRIEZ
TUURIAULT	THURIAULT
NWAKAUIHJIANGA	MAKAU-MIZANGA
IWSCELILK	CELIK
BWERTAGNAVVLVLVLL	BERTAGNA
WSANA	ANA
IMSDVLLALLL	DJELLALI
XWERVADECMNVLUL	KERVADEC
HEOUINILIVLII	nan
NMSPFALTLALBLULYL	PRATABUY
REQ	RECO
LLMMSPORDLYJJIILDLJNJAR	OROJIAN
HMINTZYLLLLLLV	HINTZY
WLIMHY	SWIATHY
LOU	LOU
WSCAROLGNF	CAROLINE
CMUOZU	CUOZZO
PIIIARAERAIYENLNLHCLNMIW	FERIELLE
LNWIFALRCLYYLLHLY	FARCY
JWSEAU	JOSSEAU
ALICIA	ALICIA
MLCAPUCLNE	CAPUCINE
PSVLCTORIALLLILI	VICTORIA
PATRICE	PATRICE
MSELVE	EVE
CBLLN	COLIN
W	NOA
LOMSPIEIILITJIIIHWME	PETIT-HOMME
DCJBLLNTGFAN	DESAINTSEAN
EWUX	LEROUX
NAELLE	NAELLE
WIOZELLLLLINLL	DOREL
DWELEPURTP	DELEPORTE
MMSTRFILYCWIJUILVI	FICOT
WSBJA	LISA
MMSTYMALSNIHVVVYL	MASIH
WLEROUXYLLVVVLL	LE ROUX
GAULTHLER	GAUTHIER
WSTUEO	THEO
PSMATHILDLELLLJ	MATHILDE
CACHELFUX	CACHELEUX
WIWLFNBIL	EFE
BENJAHLN	BENJAMIN
BEAUDEZ	BEAUDER
TWROJANILTYLVL	TROJANI
FLLAMBIEN	FABIEN
IHIARA	CHIARA
NLWAEVA	MAEVA
W	VICTOIRE
HAELA	MAEVA
WLJULEANA	JULIANA
PLHLELLJ	NIELS
HAHOWI	HAMON
MSHATHEC	MATHEO
WSAPTHUJ	ARTHUS
ANAJE	ANAELLE
PWAWLOWSKVILLVVLLJL	PAWLOWSKI
DRHGDB	ARNODO
UMLLLNBOCIYLLLL	LAMBOLEY
EOEAN	EDERN
BMWWHMLLLLLLL	BLANCHET
IWSPLLTRA	PITRA
WSTULRF	TULIE
ALMOMAN	ROMAN
TWHENHDVLVVLJLL	THENARD
BPLANCHART	BLANCHART
PILSAHANRHGCAOUAXHLNMIIW	HARGAUX
WSLBRLIOLITLLYVY	BRIOT
PAYEHINELLE	PAYEN-NERLE
GWMESNLILMNVVJVUDJJ	GESLIN
PSDIOIWIHYIEDLIWIW	MOHAMED
XASMFWA	XASMINA
HAROUESFERNANDES	MARQUES FERNANDES
LOULLS	LOUIS
MHELEHAWHM	ELEA
MPKRY	PATTY
WSSARAH	SARAH
XADDOUR	KADDOUR
GAXANCE	GARANCE
VLIELMLO	VIEIPPE
APCLLLNE	APOLLINE
MMWARNFWEIH	MARIE
RUEY	RUBY
PJVLCALOR	VICTOR
BLLLLOTTET	BILLIOTTET
BLIZET	BIZET
PSTMMAS	THOMAS
WSAWNE	ANNE
WSMULLU	ROMAIN
GWODRANILL	GODRAN
HLELYOISE	HELOISE
IAWJFL	PAUQUEI
CMHAUCHEWINL	CHAUCHEFOIN
WUSIP	BOUSBIA
LIMOENE	LEMOINE
NFNON	NINON
WSLNISLZPPULRLEFYNN	MISZPUTEN
VALENTLN	VALENTIN
WMVATWZILMEWLVJUW	VATZIAS
LMWOUMGWSENW	LOUISE
MLLMOURLOTL	MOUROT
GALEHW	GALINDO
UMLNL	DIMITRI
ANIREA	ANDREA
LMSLAYDVONUVONUYLV	AYDOGAN
WYJMRIIVUIJJERNLFITN	RIVIERE
XILNAOFLA	BOUAFIA
PSLEONIALLLI	LEONTII
OUDZILUX	QUARINE
GAUTHIEL	GAUTHIER
HESTORETNDUCHER	NESTORET-PUCHER
PSAILIELXLLLSJI	ALEXIS
JOSEPH	JOSEPH
MPSTDNELVCURUOXOSIDL	DE CROOS
PSFAYANEL	RAYANE
LULHS	LUCAS
LMSSOUSEAU	JOUSEAU
ZJILYIN	UNREADABLE
PSGULLLLLLOUIV	GUILLOU
WL	DEVANNE
JWLLUFLLLLELCLLLL	CARLIER
BLAQIYE	BADTISTE
PLLEFRRE	PIERRE
LOWS	LOUIS
FLAVLIE	FLAVIE
MEWN	GHERMAN
HLIPPOLYTE	HIPPOLYTE
MSBAPTIVC	BAPTISTE
FAVAFROUH	FAVREROCHEX
WSWDBEN	ANDREA
TWMLLWWW	TEBOUL
OMBNINFWHENW	ORIANE
GUULOU	GUILLOU
PEREJRA	PEREIRA
LASNIEX	LASNIER
PIIISOYNCILLLLHOCHWLOW	ZELIA
LLIMMELLIBUILRU	HEMMER-BUURU
MWLCAWWNW	LEA
ANHJR	ARTHUR
CARL	CARL
LLPIWZLALLLDLUAE	DERAMBURE
LAPLEXNA	ALEXNA
HCHAIRRLOTTEAM	CHARLOTTE
DMUBOWET	DUBOQUET
MMSPMLEITUUJJFFJENLJY	LETUFFE
OCULAVII	OCTAVS
SLO	SID
UMSOELMAS	DELMAS
HWLIWVWLVYLLLL	BERNARD
IOWHLTNVWIAIW	OLIVIA
CHALSOPHER	CHRISTOPHER
MBERYLLI	BERHILI
CYOIGNET	COIGNET
LWSDUDLLILFLLL	DURIF
DENLY	DENIS
MDOU	DADOU
MSCHAISISIEILIAY	CHASSERAY
XMARDYMVVYV	HARDY
LEVILLAIN	LEVILLAIN
NYALAVAL	MALAVAL
TOUANFER	TOURNIER
HLATNA	MAINA
CWMOTVELLLLLRELVJLDIUII	COTELLE
LENNY	LENNY
HLWALTHILDE	MATHILDE
TLWACINF	YACINE
BMSIAILIEIH	ROSALIE
MLVCFWLLVIIDLNLIN	DURIEZ
CXHSE	CHLOE
YANI	YANI
JUSTLNF	JUSTINE
MWMMWULTMVDJIOLSY	KARROAM
MAMIW	MARTIN
TRAVEASE	TRAVERSE
IWLYILYLBLWLYLELRLVAVV	BOUYER
CWORWEA	CORDIER
MMSTCMHIVATVTJILLYJLN	CHATTI
WPFLLEHYVLYUUILN	PELLETERY
WBECAERTVIJVLILI	BICEART
WSBENJAMLN	BENJAMIN
BLTON	BITON
IMLVSTFLLHRLGLHNELVOTVVL	FARGHEOT
LWIHALXENT	MAIXENT
LEDCII	LE DEZ
MILEA	LEA
WSTOM	TOM
IMSDAOCLHLALRDLIL	BROCHARD
YLHEO	THEO
FILYCFLVF	ALYCIB
CLFHENTZNE	CLEMENTINE
JESSFP	JESSEP
MALO	MALO
FIAJILLL	FABATIE
GWRSSWVLYVLLIIL	BRISSOT
IAMLLLE	CAMILLE
BIIGIOT	BIGOT
FPOUQUE	FOUQUE
LMSAILHOUR	AICHOUR
LLPIIILAJURLCENSINALNWLIW	JULES
ULWIWLLFLLLEHLLL	CAMILLE
LWASSAWFL	LASSAQUE
LPSHCHILLF	ACHILLE
LMMSYNYAIRVQYJUUISLJJL	MARQUIS
MWWAUADWW	MAUD
LHRRFAU	CHEREAU
TYHONASKUDEOEK	THOMAS KUBEREK
SAVANNAH	SAVANNAH
TACHOW	TACHON
WBLOLMAWMW	LOLA
MLELION	ELIOTT
PIWFLLDI	WALD
WWUEMWWW	LAEBA
WMSTMANIVDRCEOWJON	ANDRE
MMSMBMEINVYAUIYCHTAJJV	BENAIGHA
LAFTLTIA	LAETITIA
LPLSYFHJWNHWIW	LAURA
LPSLEPETIT	LEPETIT
MMSRCMHIJDADTUILCYCUH	CHAPUIS
JMLLEBLEGUEL	LEBEGUE
AWWHENLWIEHM	AMELIE
HODY	HODY
PCADRJEN	ADRIEN
RAFFAELA	RAFFAELA
AWWNAMIWSNW	ANAIS
SIWIOVJULEHLLXAHNELLL	SOULEIMANE
NLMWW	THOMAS
YWMMMNWNAM	YHANN
LMTLDNELFVFTITUENUUXJIJITHFQOT	DEFFIEUX--THIROT
AMLLLELL	ALLIE
ELLOISE	ELOISE
JMSLLEVRELL	LIEVRE
FWKOQDUOWLDLLL	FROIDEFOND
WWANAUYUSHWIIH	ANAIS
WIARTJAJD	ARTHAUD
ANTONIN	ANTONIN
EMMLE	ERTLE
MMSMMBNIFUHLFYTUVSL	BOCHET
WLESTEBAN	ESTEBAN
SLLAPWA	SANA
PLSIANALA	SANAA
BWLHLRON	BLAIRON
PIEIVELLL	EVE
LWSCINDY	CINDA
BERNARD	BERNARD
MMWHHWEIW	BAPTISTE
PAUL	PAUL
THEO	THEO
FABPE	FABRE
PJIQIIZLOLLLULRLLOL	PIZOLAT
WSHFPPOCYTF	HIPPOLYTE
HSCAA	LASCAR
NMEML	THEME
VALLEE	VALLEE
GBERAM	GERARD
APRTHUR	ARTHUR
PIEARE	PIERRE
MWINBNGWONM	FABIO
IMMSRMDELRVJNEJSJLJIL	DERRES
NYOVRIMN	NOURIMEN
WIIRENE	IRENE
TYABARD	TABARD
FWWWETLLL	FOURQUET
MWENARD	MENARD
WICHFH	DUCHENE
KNMSSAOVD	BEN MESSAOUD
HWWLMEWWAM	SELENA
WLNLLFTTE	JULIETTE
CWLLFRBMNLEAUULLLLLL	CHARBONNEAU
MMSTCMALNLUAUFVALTVLC	CATTAERT
PSSLLLA	SILIA
PSBEWJHNLN	BENJAMIN
MLLCTTLLUVLLIJLELIRLVL	TUILIER
LMSLDALRNLALPILILL	DAMMAN
PJGELRARDLL	GERARD
ELOUANN	ELOUANN
WMSTMFALVLLJVLLLVUU	FALL
MAXLUALS	MARCHAIS
HUWRNEWAHNW	MYRIAM
MMSRLWELVCNVRELUURJEIRY	LE CREURER
YLIBARTTH	MARTIN
WSBNULLQWD	EMPPTY
LWSGEWLILRLLLELVTL	GENTILLET
IWSKNZEIIH	KENZEM
SMMESSAEATVJLLLV	SMESSAERT
BWNCHCVMOLRELYIDVYY	CROCHEMORE
AIWHNAUILSWJLH	ANAIS
MSWNS	DESMOUS
WJNAEL	MAEL
ELLIOU	ELIOTT
HWWWF	AMINE
DLWNE	ALBANE
BOVHADJAOJ	BOUHADHAOJ
TIHOTHEE	TIMOTHEE
TWSALSFLAYLVVLLIL	TSALSELA
XSCAUET	CAUET
PSJULES	JULES
DWMDE	DADDE
LLPSCLHIAYISTIHLIINWIW	CHRYSTAL
ATAZ	ATTAR
DAVLD	DAVID
PSKOWRAD	KONRAD
HNCEO	MACEO
UAN	ILAN
AFOBER	ROGER
HOHILLET	MONTILLET
RLCO	RICO
HEBBINET	HERBINET
TMCHHRNAXVI	TCHAKMAKOSI
WLPVED	DAVID
CECILE	CECILE
BELADGAAD	BELADGHAM
WMOEMGLLVA	GONES DA SILVA
WWNNETON	BONNETON
BIWHWNXMLEOWHIEW	BADR-EDDINE
CHERIFII	CHERIFI
UE	ZOE
BROVAS	BROYAS
ENNOUAPI	ENNOUARI
CHEW	CHEN
WMSMMUISVYXUVTULIJ	BOS
FLVPIILW	EVA
WSCHLOE	CHLOE
MMSTCLLHLVOVUDIVLTNR	CHOUIN
AURELLEN	AURELILN
STFSH	SIMON
IMMDJMOULWADIEUNJEYYYIJL	IDJOUADIENE
JOSCIPHLNE	JOSEPMINE
ROULLFAU	ROULLEAU
VLCTOR	VICTOR
ALMLICE	ALICE
WMFLONRWLANIH	FLORIAN
AMAURU	AMAURY
LOULS	LOUIS
CMERONFVLLLLVL	CERONI
WSIDRISSL	IDRISS
WIYYERYNLEAUL	YVERNEAU
PSDOHAAEDIAZFBROUK	MOHAMED-ALFAROAK
NAGUER	NAGUER
WSSONIA	SONIA
ILEMENTIWE	CLEMENTINE
PSCLENEWNF	CLEMENTINE
RFGLW	REGIN
MMSTURRLVBAUJINWUTF	URBAIN
NACY	MAQY
HAYLLS	MAYLIS
MSFATLNATA	FATIMATA
LIWWOMNEWNW	COME
WCKLILLLLAN	KILLIAN
NMWASSON	MASSON
FELSRE	FEIGRE
MCWAPNUWCINENM	CAPUCINE
NLIE	JULIE
CNLOE	CHLOE
WEZROS	QUEIROS
BFAYNN	BRAYAN
CLEHEWE	CLEMENCE
YOUASY	YOUNSY
WSLBRLLDVONURXLULLL	BRIDOUX
IWICDHAYFS	DESHAYES
UWANJWILIPPEL	JEANPHILIPPE
MDEL	MAEL
WEXONEIAYYYLYIVV	FOXONET
LAURA	LAURA
MMLFWVLVRUISVUVNU	KORUS
BWOUHOU	BOUAOU
CWMANNWLLENM	CAMILLE
MLLLAC	LUCAS
WMIMRMOIUALBLFNLSDYFLL	LORBEL
MNWK	MAGNIEZ
ROINTELAS	COINTEDAS
NWILOLASYDVVLHQL	NICOLAS
PSHUJTLLN	AUSTIN
WYHOU	ZHOU
WMUALAHLVUVLLLL	BOUALAN
VALLF	VASSE
TUOUAS	THOMAS
WSHFLLLSSA	MELISSA
WLPLALH	SARAH
NLBUNBA	MBUMBA
FLE	EVE
LMWSPMOFINUOVYTLTAJTJTLV	DEMOTTAZ
GUSLLST	GUILLET
WWIZARRLAIIIIIID	DE IZARRA
LPCCCA	LE COCA
AMARA	AMARA
MWNATNAWNHW	NATAN
CLFRA	CLARA
JAM	JADE
CULNET	GUINET
PFLULLLWE	PAULINE
DWELASSMYLEVVLYVLLL	DELASSALLE
ISAURE	ISAURE
LWALSNFIL	LAISNE
BWLTLERLLLOHVNIJVUW	OSTERCOH
BETLY	BETTY
LWABEUYEREL	LABRUYERE
WMWOMDWYNW	MADDY
ANDILS	ANAIS
JLWIAWJLLLLHLH	JANELL
WLWEIONWIW	LEO
REYDELLET	REYDELLET
FWSDJFISNLOISLI	DESNOS
PWUHSONLLL	PLASON
LETLCIN	LETICIA
PLISLIELAHNNHLAIWW	LEA
PSTRAHL	TURAN
FLORLNE	FLORINE
CFNIIALJI	CANTAIS
IWSWHLLOULL	BAHLOUL
JOBIE	JOBIE
MANFE	MANFE
RAPHAEL	RAPHAEL
LHCOH	NACIM
LPSYLALAHIILHJL	SACMA
PAUL	PAUL
LYAOCX	LEROUX
PSAJVIEN	AJAIEM
YLSWLLRILERI	POIRIER
WSAYWENN	AYWENN
PFSALIN	BESAIN
CHASAWON	CHASSAGNON
WCWLENMHENTIIW	CLEMENT
RLICNLNNAHLITSNAIONMIM	ANAIS
PIGASPARD	GASPARD
HW	THIOT
SHIREL	SHIREL
ULYSSE	ULYSSE
WMLRHRQLVHWYLOLLLUCYUEF	HADJ YOUCEF
DWLOIS	ALOIS
VLLLEPONTWX	VILLEPONTOUX
PLILON	PILON
WD	DOLD
LHONLGO	LONGO
RLTNLLLENU	RETALLEAU
CLLOYISE	ELOYSE
VEFCASSCN	VERCASSON
WLEFEBFYRELL	LEFEJVRE
RONIILN	RONCIN
DWWUYERUVJLUJIN	DUDUYER
WSSOLYWE	SOLYNE
WCXDRIOH	MARION
MRSFLLLALVHYJVVVIJL	LAMY
ALLAW	ALAN
LWJNOWTINN	MONTINA
WNIFER	JENNIFER
LMLLBLAVNITVUHVNVYL	BLANTRON
WLOBALLLLLLLLLL	OBAL
CLENEW	CLEMENT
LPCBASTLDON	BASTIDON
BWMAVMWLMLWUMYTYLH	BAUDOIN
WWLMOMRIOLLBLDZNALSJK	BOULROT
CWHLAL	CHAHLAL
LUWIFNJONHHLLL	MANON
MNBOAHAWHAW	NORAH
XEVIIN	KEVIN
NLWPTNPD	MATTEO
WLNADLH	NADIM
TITOUAX	TITOUAN
WNAROUNVLLLILLL	MAROUN
PARBTIIVIOAL	PARAT--VIDAL
HATHAH	NATHAN
SMSNICIOLHL	NICOLAS
MBRE	AMBRE
IWSMOAANAL	MORANA
MSVALEXTIN	VALENTIN
CHHLUVLNEAU	CHAUVINEAU
CWUARDISFBOUWF	COQUARD-SIBOUNI
MMIPSRALUYLALMVELNVTJON	SACRAMENTO
ALUN	ALLIK
WMUERVLMVLVDJJVV	KOEV
MMSTCWALDVILOVLUVVIL	CADIOU
CLYAFRA	CLARA
PSMARINL	MARIN
BMBLLLEUX	BAILLEUX
BURBER	BURGER
CESARIE	CESARIE
ICWHHANRWLOTTKIW	CHARLOTTE
ANNEIHELENE	ANNE-HELENE
CLARA	CLARA
WAMY	VIANNEY
PSNIIRIFIRAYJLALLF	JEREMY
UQATEAU	GRATEAU
LLWIELLILALLFLL	LELIA
IKWHAOUBWADOJULH	KAGBADOU
EOUDJIMA	BOUDJEMA
EHILIE	EMILIE
IWWEMTI	CLEMENET
MPSFMRIUFLLILCIOJTJJL	FRELICOT
TACOGUOLS	TARAQUOIS
JULFIS	JULES
PSFLAVLIE	FLAVIE
SAILLON	SAILLON
WIWJNILIDNTL	RICARDO
ANWN	ANNA
GFODARD	GODARD
PSKIOIMLALHILILHI	ROMAIN
DPUMOULIN	DUMOULIN
UASSANCXU	KASSANDKA
KERDAAT	KERBRAT
PSAWWE	ALINE
WCVALERLIAN	VALERIAN
QPVEHTIN	QUENTIN
WANGER	GARNGER
EWAB	EOGAR
LLYH	ILYAS
WWMC	AGOSSOU
AWJFARLILW	FARDI
WSLUCIE	LUCIE
WZLCOUYZVILNLLLL	COUZIN
FLNULVJLULBILIY	COULIBALY
MMLMMWIIUOEHUVLOJL	BRIOUL
SMERRERVJJLV	SERRE
OWMOWLVNMVILVLVJL	GOBIN
YANIS	YANIS
BAUCLOT	BAUCHOT
LMILBRAYDLVLLLIVL	BRAJI
CORENTIN	CORENTIN
LPSARTHUR	ARTHUR
MLSFMLLORYOINJVVDYL	MORIN
ZIANL	ZIANI
BRACCO	BRACCO
MAHEUT	MAHEUT
JEANNE	JEANNE
AQTHUA	ARTHUR
HARLIO	MARIO
PLLUCIE	LUCIE
CONSTANCE	CONSTANCE
KESSLER	KESSLER
KLLYAN	KILYAN
AWSBAJYVARLDLLLL	BAJARD
RAXENS	MAXENS
AE	AXEL
IWSLPREALULXLLL	PREAUX
WIWWPW	KENTIN
HIIULAE	NICULAE
SALMAN	SALMAN
ECLL	ERIL
NLVLIAN	DYLAN
HOYUNFYRAC	MOUNEYRAC
MIEFZO	ENZO
MSCAL	PASCAL
DMAJLVA	DA SILVA
WMAND	MORAND
WSGRAYVYOVUPLWLVV	GRAVOUIL
NWISOULLAS	SOULAS
KYLIAXN	KYLIANN
WWUVLLLLFVNVURL	HAUVILLE
NGULEN	NGUYEN
PLMALIE	MALIE
LYHEUKEJLILELILT	LHEUREUX PETIT
MSCAMILLF	CAMILLE
MAYLFS	MAYLIS
LSMCTEFAW	ESTEBAN
LEWM	LECONTE
PSJLULLILIENTIYLELHIWLW	JULIETTE
GWAAFFIN	GRAFFIN
MTTHLEU	MATTHIEU
CWALUTYLVVVLVL	CALUT
WCMATUILDI	MATHILDE
LOVLJA	LOUISA
PSLBPTISLE	BAPTISTE
WLHBHRKLIHI	HOMBELINE
COUDURIER	COUDURIER
WIRUHRLIYAR	NORMANDIN
WSFLOHLAN	FLORIAN
AXELL	AXEL
OCPEANE	OCEANE
VLIANLNEYLH	VIANNEY
LMJLIEML	LENA
WNGER	DANGER
PCLLCAS	LUCAS
JADE	JADE
LPAURLNE	LAURINE
QWWUEMNWTINNW	QUENTIN
IWSLINALEA	LINA LEA
YLISPHNERNPIJLNNHELINWW	PERRINE
AWUBRYLLLL	AUBRY
SMWGHMWWNW	SIMON
HAUD	MAUD
BAYCN	BAYON
LOLA	LOLA
WTMLILYLLYYULJVOJTJ	TILLY
EHNA	EMMA
NHNOW	MANON
ANLDFRE	ANDRE
WSJCSE	JOSE
MLAUAERT	LAMBERT
MAEVA	MAEVA
BHLH	BHIH
WWGINAYLLLLLL	VAGINAY
MFWILS	MINOIS
HMWARNIWEAW	MARIE
NLAJYLLD	NAJIB
TRLSMN	TRISTAN
IWSLNAJVLBLFRELLL	NAJBERG
LNMVSA	MUSA
MSNILLEFERL	TAILLEFER
LPLJLOAINNIALIIIWIM	JOANNA
OWUWERTELLLLL	BOUNJERTE
LMSREWLRELHL	REDUREAU
VLSSON	PISSON
MGMASYLLWDJONJLLL	GAS
RAPHAELLE	RAPHAELLE
CWAHILLLE	CAMILLE
LPSNOMS	THOMAS
WSJULLEN	JULICN
EMBRETONLYLLLLL	LEBRETON
PENNEC	PENNEC
CHLEYLSEA	CHELSEA
HMSPVBELVTVTAVHLILRL	BETTAL
BRCL	AREL
PSHATHYLDE	MATHYLDE
WMSMHMLIIUIFLDJYDDYUBK	MILLARD
LPJWITACLROUTE	OITACROUTE
MMSMTMUIULIJDLWZJVVN	ZULIAN
DSTINB	JUSTINE
TMWEONWWNW	TEDDY
LUBIN	LUBIN
WLLAETIZIA	LAETIZIA
JEHANNO	JEHANNO
PERELRA	PEREIRA
MMSPMBAIVADLDOLNJILC	GARDON
AUDREY	AUDREY
GOBET	GOBET
MSUALOSSFR	VALOSSI
LEL	CETI
PARJS	PARIS
HFJLLIRRLOPEZ	HELILLI--LOPEZ
TUFCLIGO	TUFFIGO
HWLLPAGVNLOOINUVUH	PAGNON
LMSLZAVNILELRLL	ZANNIER
UYLNGUE	KINGUE
CWWHAMAWLONNW	CHARLOTTE
PLWAFALDLL	WAFAA
RWSGREGOIRE	GREGOIRE
WSTIDN	LANDES
PSEUGFNLE	EUGENE
EWWRA	ENORA
FERRY	FERRY
MSAUBAUX	SAUBAUX
PSNICOLAS	NICOLAS
ALNPMS	ANAIS
WSSSAL	WISSAL
WILWMPWLHL	OTHMANE
WULIM	PAULINE
LWSLTVLLENLEYTLYVLLL	VENET
SCICK	SECK
PINEAU	PINEAU
MLFMIISVYYGZYVY	LE BRIS
PCLUCIE	LUCIE
LOLA	LOLA
WTWIHNOWTHENW	TI MOTHE
SWOL	SOL
LLMMSMCMILUAYILSLDADLYSN	ASD
TWEKLN	TEKIN
ANTONE	ANTONE
CHARLGNE	CHARLINE
JLWEANNE	JEANNE
DITTE	DITTE
WSLOAAN	LOHAN
KWIN	KEVIN
MMSMBMAIURRNOUULLOLL	BARROUL
MMILLFT	GUILLET
OEANTONI	DEANTONI
SALHA	SACHA
MSALLILE	ALICE
MLSEBASNLEN	SEBASTIAN
IRGUI	IRGUI
NMWAONHWLHW	NAOMI
KUZNETSOVA	KUZNETSOVA
PSPILLERIICAHUUL	PILLER CAMMAL
LENHU	LE NOTRE
PLCAPOLLNE	CAROLINE
GARREAU	GARREAU
LAWNTOILNE	ANTOINE
ANPGE	ANGE
AMARCON	MARCON
CMAILLNEVLJLYLVL	CAILLOCE
ANWE	ANAELE
TIWHHINBWAUTILW	THIBAUT
BCHARD	BCNARD
IWISODVELTYVVYIV	GODET
TSDW	TISON
MMSMQMFIUJJFAJULULUN	BIZEAU
PSRAZIME	MAXIME
RYAD	RYAD
WADIA	NADIA
WMERHAUWR	OBERHAUSER
HELANIE	MELANIE
HMWMMWEASNW	MATHIAS
WWMRMRFMLRAVTOGGUUN	FERREIRA
WMSMMLAIURRYOJUIFUSJT	LARROUE
MSSACHA	SACHA
LMMLMRFIUDJTSIDHYJBL	BENJIO
FIESCHI	FIESCHI
NLWIHJHAFNLLFLLLL	NATHAN
NFNO	NINO
AUBERT	AUBERT
WTSRRILAVIWIVLLVY	RIANE
UMSMWLLLLLLL	MAYEUL
DHNIEVILLE	DANDEVILLE
UESTA	CUESTA
EHZO	ENZO
GOM	COM
MMIPNMUIGVEDJRJVUYY	NUGER
HORANEE	HORANGE
OWUZSUENULYYUV	GUIGUE
FMERRAND	FERRAND
UX	LEA
BOUCHET	BOUCHET
HHICULFF	MAKHLAF
WPLFMLIVWJJNQRYNDVJNUL	EL BARROUDI
WMLMWLCLYULINUXLICCEIIXIIRI	JEMANISSIET
WMLMWNSUUGCANNILLISIW	MAUEROIS
NLIOLAS	NICOLAS
WWIOUALIO	DI-ORAZIO
LAURENT	LAURENT
DWUFOURVILLLILL	DUFOUR
LAUAENT	LAURENT
WSVLLANNEY	VIANNEY
NLNA	NINA
BONNETLEYNARD	BONNET-EYMARD
REMOND	REMOND
LWQIUSLLYFILHLH	QUSTY
CUIIINENT	CLEMENT
LWIHYRFAM	MYRIAM
HDAEEN	ADRIEN
LMMSMAMYIFVCJUJLJILV	AYECH
IMLUMLKLLL	COME
HURTAVD	HURTAUD
HIAELYS	MAELYS
HWQHJEVCMLLYXVLY	MEKHETTECHE
MSLTRELVLYLSFHNLYL	TREVISAN
WWLMCMDLCVINJNKTZZHZNFL	UNREADABLE
MALLEGRINO	PELLEGRINO
WIPOHANE	ROMANE
WSIILTLITL	BATA
LONBLN	LONGIN
PRLIGPYRE	PIGEYRE
JESHERAUD	DESHERAUD
IWSLNELLCINVVALLIIL	NEIGNAN
WZADEC	ADEL
BPUISE	LOUISE
HAWI	HADJI
BWETRANCOLURLITLLL	BETHANCOURT
GLQUELLO	GIQUELLO
LWSALLICE	ALICE
RICHARD	RICHARD
JWLYSFMMELRVVLIJWLLIUL	MERLIN
CYAWU	CABAU
WMWNADWIW	ROHAIN
SRECOLPE	GREGOIRE
WSILYAS	ILYAS
VAUGLN	VAWGON
SYODOT	GODOT
NEFF	NEFF
SWCHANGLL	SCHANG
IMSSALLYL	SALL
WIRON	VOIRON
OWER	OMER
LLAURW	LAURYN
AWAYOGU	AWAYOGO
MMSRDMFIKUFUDVFVVDJL	DEKENS
PSMAXLLNF	MAXIME
SLWIARLAHFIHLH	SARAN
UWSV	COSTE
MMLTBVFLVRCLHIEWRYLVL	BERCHERY
CMWASNSWANDRAIM	CASSANDRA
PSGUIBLEFT	GUIBERT
MSMLCHAEL	MICHAEL
HPLLPOLGVNVOINLVUIV	LOGNON
HCLZ	NOAR
WIBBSLLCLJ	BASILE
MWWLCWLANW	ALICIA
IMSSALLLELL	SALLE
LWSCLARA	CLARA
WSNAEUA	MAEUA
NWSDEHOILNEL	LEMOINE
NATHIEU	MATHIEU
KOC	KOC
DNIN	DAIM
LHLOE	CHLOE
NARTY	MARTY
WMLLLLLTULLYLVU	BIGOT
HOYS	HOYS
TLMOHIA	TANIA
MMLMMRNSPWTNSUQGLE	BORTN
BOURDAREL	BOURDAREL
IWLCHDRLRELNTLTELA	CHARPENTIER
WIELOUAN	ELOUAN
PIAOHAUE	ROMANE
NWSLWVUWLDYLRJN	ROUAUD
PSTRLSTAN	TRISTAN
LOIC	LOIC
CALLXTE	CALIXTE
WJLOVLS	LOIS
TWWAHNEWRHW	TAHER
WRONSACUDEN	BARON SALUDEN
MATTHIEU	MATTHIEU
JWVLYLVFLFVEJVWREJVLI	LEFEVRE
UXAOE	ROXANE
WMIRMIRIAUQNZTJOJJHX	IRANZO
LLANL	CLAQA
RAPHAEL	RAPHAEL
LFFEVRED	LEFEVRE
WFWLLLYULLLULTL	COMPOS
PETREMENT	PETREMENT
WAOOUACHI	WADOUACHI
ANGELO	ANGELO
FMOSSEYVMLHGD	FOSSEY
WSPAL	POL
WYAWZL	YAVUZ
CHARLEUE	CHARLENE
HARLFH	MARIEM
MMLMDMDSUTUCYJUWLJJ	PATEY
IWLFUEIN	RUFIN
WJALICE	ALICE
LLPIISCIHNANRNHADNTATZIMMINM	CHARLOTTE
TOYNY	TONY
BELHEUR	BECHENR
WSVST	JUST
EMWLONIWBNW	ELOISE
ISTWW	ESTABIN
WMSSSF	ANISSA
LNWSLFLLFBOODLEL	ELLEBOODE
WBLLOULGLIOYVVUVYWL	BOUGIO
CILHEA	CLECHET
WLWEYNAWAM	LEXA
HWWARMIWNENW	MARINE
WLWLJLHEJIH	JULIE
WWWHVLJYVJLL	DOGAN
WJOWE	ADJOUTE
WSTEPHAV	STEPHAN
PSDIANEL	DIANE
LMMATHIAS	MATHIAS
LWEROUXYLVLVIL	LEROUX
LLWMSMPMOINVOTATALJLOIFAUR	PONTARLIER
LEONLE	LEONIE
DMECOGNEYIVYUVIL	DECOGNE
WLNIIOLAS	NICOLAS
WSCSRAL	CLARA
PSMIALFHIHL	EMILE
HEMYI	HERRY
JAN	SAN
PSLPILLRLSLOVILLLVAPXAY	PIERSON-LAVNAY
ALGATHE	AGATHE
SLLPVSPY	SUSY
HEDCENT	REDCENT
ALIX	ALIX
MAXIMF	MAXIME
PISTNWILNNLNWIW	TOM
LPPHSCO	PASCO
DWAULSSYLYVLVVVUU	DAUSSY
MANEL	MANEL
BRILLIUD	BRILLAUD
CWUULDZIN	GOUARD
CHHLLLE	CAMILLE
LLMOUNA	LOUNA
LMMEWYFIMGMOMVJJLUJUJ	LE MIGNON
DAJIC	PAJIC
LTLNCANGO	LINCANGO
UCLLULL	UNREABLE
MEELFSA	ELISA
MAUNE	MARINE
PAUL	PAUL
WSLAURE	LAURE
MZLMONLTLAYGLNELL	MONTAGNE
BWAUDL	BAUD
EWWLIWNWFAU	ELINE
MSLAUVBLFRLTULVLL	AUBERT
HJSEGGCNT	SERGENT
FMSBOUUHLSL	BOURHIS
WSDDTLILDI	ARTHUR
VMLCNE	VIGNE
DUPONTIROUGIER	DUPONT-ROUGIER
LAQRUCHON	LARRUCHON
ROUAUX	ROUAUX
ENZO	ENZO
VZCOT	VIGOT
LUCN	LUCAS
SIWHAMUHHILW	SARAH
WBWAPNTWISTENW	BAPTISTE
LMSVASLSLEL	VASSE
WMSMMDAIUUNYNYYOBSDJL	BAUDRY
SAFPE	SARRE
BOWUADO	BORDONADO
PLNZLOLAS	NICOLAS
JJLLETTE	JULIETTE
YASFNF	YASSINE
SOARES	SORRES
MEAUEIILLF	MERVEILLE
MMSTPDOLVLEJTJHYJJL	DOUET
TERNOIS	TERNOIS
WINUILLLLIL	CORNAL
GWUZGOULILLLLLL	GUIGOU
CILOE	CLOE
LENFANT	LENFANT
AZNIR	AENOR
VHNMHLLEGHEH	VAN MALLEGHEM
WMS	REVET
WUWLLYLL	LANG
LNWOA	NOA
PSYANLS	YANIS
DIEDRELOVIS	PIERRE LOUIS
JWOHENLLLVVH	JORGE
WULANSER	BOULANGER
HIFPAHEZANLISADAT	MIRRAHEZANI-SADAT
MOALSOB	MORISON
ABBFDIIFLNTUCCL	ABBID-PINTUCCI
PLTEANNE	JEANNE
DORIAH	DORIAN
ZALESKI	ZALESKI
LPLEIILJT	ELIOT
BMLPMGUIVILJLJJEMJOVWTTT	GUILLEMONT
MSNLIA	JULIA
ULRREILOWEAU	CARRE-LORMEAU
VASANTHAHWAN	VASAN THATHEVAN
LWSAGATHE	AGATHE
ROMAIN	ROMAIN
CMLLU	CAMILLE
XSGUERINLL	GUERIN
BCWNEFOY	BONNEFOY
AQUL	PAUL
BOUTET	BOUTET
PLYASSMINF	YASSMINE
BWPLSAFD	BRISARD
CHOQUCT	CHOQUET
ELWIDOLUABLLDLLLL	EDOUARD
LLPW	LUL
ADELFNE	ADELINE
PSFUNLDL	GONZALO
HANON	MANON
JAUREGUIBERRY	JAUREGUIBERRY
TWWINNWANW	TITIA
HAMANA	HAMANN
CPWSANDRA	CASSANDRA
ELOUAW	ELOUAN
HUGO	HUGO
HWLLOLWLLYYVVVVVLU	HOENIG
WSRFNOUANF	REDOUANE
WLZAKARYA	ZAKARYA
ELM	EL HARRAMI
BFSSON	BESSON
WMSTGNALVUDLJIVHOLOU	GAUDIN
WLLOUHA	LOUNA
CELENA	CELENA
ILMSLRIVCHULARLDLLVR	RICHARD
DYUPOHT	DUPONT
ELILSH	ELISA
PLISHLOLAIWIEIIIIHWIM	LOANE
ALELYA	ACELYA
MRLSTLLLEGVMEDZNALLGI	LEGEDZA
MFNW	ENZO
SMFBATIER	SABATIER
CWWAAWUWCCAW	SAMUEL
PSGALLLAHNID	GALAND
WLLXJDN	KILLIAN
TMHUAULTYLLYVLU	THUAULT
PPALAT	PPLAT
ARTHUR	ARTHUR
JARMAFIZYK	JARMARCZYK
UU	LOU
MMSMMDDJVFJXTJVJVVLL	LERAT
DEELOO	LEELOO
DWNAAVLLLLLLLL	LECANU
ULIISNLUAGJOJJOOJWOM	HUGO
MARTLH	MARTIN
AWQEIKELLYHA	ANGIE-KELLYSHA
MMLSRCMOIVURLADNUOTJOJ	COURANT
MMSRPMSLUCJUWUYRDJUL	PESCHARD
MYAGES	MAGES
DWFYIDIECHLELGLWLLLL	DAVID ECHEGUT
ARNAUD	ARNAUD
LAWPY	LANDRY
NJLAN	NOLAN
LCON	LEON
LWWEOMWAWNW	LEONA
BME	COME
BLANCWN	BLANCHIN
MSCLFHENT	CLEMENT
PSCHLOE	CHLOE
PZALYCEA	ALYCEA
MHONORE	HONORE
WIRLYNLF	DUPREZ
VQCTORSA	VICTORIA
LWWAHDIWLLEW	CAMILLE
HULHETLBLLHAXD	HUCHET-GIRARD
MPSBNOLUVRVOLLLLNJLL	BOURDIN
XMMLWLUMEWWL	DELHOMME
LAFIU	NABIL
WSANI	ANI
WILCUIHS	NICOLAS
ALMANZX	ALMANZA
WMRLJVALRVVUUYN	IEZZA
IMRSYLLLELBLPJALKUSLLZ	LEBBAKHAR
TWPEHELN	TREHEIN
WWWFTYLVLVILL	ANQUET
KLLLLLM	KILIAN
LPSTANUUY	TANGUY
ECIO	ECIO
BOUZLDL	BOUZIDI
PSLOUNH	LOUNA
PSANTHONY	ANTHONY
CAMELLW	CANDELIER
PJIVOUID	LOUID
URUN	URCUN
PIWNA	ANNA
RWIBELWLLLLLLL	RIBEIRO
SLDRLANE	DORIANE
LWSWELYNF	EMELYNE
MMLRAMLIVAMJUABVGVOLTVN	ALAMARGOT
LLMOHT	LEMORT
PCHDDH	NOAH
TWAANVOUEZ	TRANVOUEZ
GMUILLETLLLLLF	GUILLET
FYRID	ASTRID
PIVLLIICTORLILLL	VICTOR
WSYARILS	YANIS
WSKOULLVLELLLALSLYL	KOUVELAS
WISALAI	SALA
PLCROWNLVL	CROZON
MAWNANNWDINENW	AMANDINE
LMSICHLAMELLL	ICHANTE
WABDRMILWWAW	ADRIEN
IMSOALEYRYLLLL	DALERY
STAHLI	STAHLI
PNABDXAVMD	PITARD HAVARD
MLBAUULFR	GAUTHIER
BLFKE	BLAKE
SLILOLHAUA	SLILO CHAWA
WWCYHJIDLLYLLL	DUCHATIAV
PZEILOLVIMVLL	ELOVAN
PSAAJLTRLLLLL	AAMIR
WPFISFE	BAPTISTE
ZOE	ZOE
MSLSSA	LISA
LOMLWELRLEL	QUERE
KUBLT	KUBIT
NWTLUYLLYLVLL	TETLEY
MILLIER	MILLIER
AKAKPO	AKAKPO
WIAHURNEWLFEIW	AURELIE
TWMUDGNWASW	THOMAS
DIILOO	DIEGO
PMWLALNLLVLLVL	POULAIN
MWWHIWHW	KEVIN
HALYOVNA	MAIMOUNA
HAVJEAN	MAUDEAN
PSILOWA	ILONA
MFLORFS	FLORES
FDVV	PAUL
NLCHFL	MICHEL
IMLKFTLLIMRLLEVRCIUTALUI	KAZMIERCZAK
LOUENN	LOUENN
EWVA	EVA
FELIX	FELIX
DAME	DAME
MMSMTMHIXWIPLLLUYHZRYNN	THEEBLYNCK
FLISE	ELISE
ALWIDWLLL	ADAM
AHTTFO	MATTEO
ABDELHEDI	ABO ELHEDI
COAENTIN	CORENTIN
ADHEEN	ADRIEN
LEA	LEA
VCQDES	JACQUES
FHRAH	FARAH
MCWHINAWRAIW	GHIARA
ULEWLIN	VALENTIN
WWIMCWNSVUJONFONTZHZIPLL	GOURDAIN
HUSO	HUGO
HORON	MORON
PSENZO	ENZO
LMAIDLNLWIHLH	ADRIEN
PWERFLYLLLLIL	PERES
GUILHEM	GUILHEM
WPERESLL	PERES
BOVRY	BOURY
WRWNWMWNW	RONAN
NESFLINE	NESRINE
XMWIDNIWAAEHM	TIDIANE
CATTOT	CATTOT
PJSIELBHHLTIIEIHLWN	SEBASTIEN
LPSHDNONLL	MANON
COTTEREAU	COTTEREAU
HLWANTON	MARION
PSALWENA	ALWENA
BOURGUICNON	BOURGUIGNON
LUCJE	LUCIE
HCUY	HOUY
HMARNORON	MAINDRON
THOMS	THOMAS
AKEW	ARSENE
FLORIAN	FLORIAN
NMWATMHWANW	NATHAN
LOUILHON	LOUICHON
GMREGOIRE	GREGOIRE
PLDJLANLCO	DJANGO
WSALCHA	AICHA
NWOUNLER	MOUNIER
HATHILDE	MATHILDE
DWERVILLELYLLILY	DERVILLE
YELIZ	YELIZ
WMLTRNULVHLAVYUVUN	ROCHA
GOBINET	GOBINET
LWSRAPDAEL	RAPHAEL
PSFABIEN	FABEIN
GMLDIELLIDLNWOJIY	DELANNOY
IWZNOL	NOE
FLOFENTLN	FLORENTIN
DWUPRAT	DUPRAT
DLU	DIAS
GWULLHAROILNLLHWLKL	GUILMARD-SCHLICK
ITWW	PERRONE
CHABEAT	CHABERT
YRETER	RETER
RLEGNAULT	REGNAULT
OILLIAN	GILLIAN
CMAHJ	CAHEN
WWLITOUI	ABTITOUI
ANAELLE	ANAELLE
WSCHARLOTE	CHARLOTTE
THHELOIAW	THEO
PNTOLNS	ANTOINE
WLLLLSFLWLKLALNIALLLIII	BAKANA
PSOSCAR	OSCAR
LJPULLETTE	JULIETTE
AHLLAL	MAXIME
OMYRILHYOOYIPVEUSBUNL	GRINGOIRE
WPAVLHAN	PAULHAN
PIISOHLAKAIIONNHHLNWIRM	MARION
CWWLEFLUUVVLUV	COMTE
MLRFPUWLLLLCIL	RAPHAELLE
MRASSENT	RASSENT
FRANSOLS	FRANCOIS
JMIBFRVNARLLDLL	BERNARD
AWM	ALEXANDRE
PLIISOCALAAPJAOMALWIIIM	CLARA
MMSTCRHLVQLVALRVVDYVV	CHILARD
WMSPMLOIYPCLZLDLJJI	LOPEZ
YENTAHIR	MENTASSER
LDPROULOUT	DROULOUT
COCHF	COCHE
WSCHARLOTTE	CHARLOTTE
DEBEFSE	DEBERSE
WSLWNWMM	GARON
WYTHIS	MATHIS
LLLLHFRL	RICHARD
JULIENNE	JULIENNE
WPKERLLLLLL	PAGER
THEOLIME	THEOTIME
MMSTLPWLVDFSLVJLUL	LOUIS
YWA	YUNA
LFHLROLDRIGUES	RODRIGUES
RWIARNAVLLT	ARNAULT
NOLAY	NOA
PFTAOQS	PITHOIS
WLLOULS	LOUIS
OLALRLA	CLARA
MMSPBMRIVETHNELALUDJDEHLU	BRETEAUDEAU
WMITCNHIRVELTJILELNJJN	CHRETIEN
WNZALEZ	GONZALEZ
VAHDAPELIRONWT	VANDAPEL-RONDOT
DWWELMLWANW	MELIA
ORIANE	ORIANE
FWRWENTINYLVLYLLL	FROMENTIN
ELHOUHI	ELMOUMI
IMSLZELKLRAYORYULTLL	ZEKRAOUI
WWWMWNW	ILEIDILLAH
LPLYSLGLEIILIWIW	YSEE
NALO	MALO
MANAUX	MARGAUX
HCHLLUCENW	CHOLE
CWOZNEAL	CORNEA
YPWIK	TIPHAINE
PSCLONSTIANCEI	CONSTANCE
WWEAN	GAETAN
LSMDLOHE	SALOME
EECKOUTE	EECKOUTE
PSKHALIS	KHALIS
WLMLIW	ANNA
NLPTENNA	MIENNA
W	BRUN
MSZEROUXI	ZEROUKI
NDTHAN	NATHAN
BWARBELVJLILULD	BARBEL
CLOZSEAV	LLOISEAU
MMLMWMOIUZJNIINEZLDROZR	WOZIEZKO
BERTELLE	BERTELLE
MMSTGMIIRNWJRLELJVL	GIROIRE
WILEA	LEA
WLWUR	DE BACKER
WSLEONAPD	LEONARD
MJLVUULILLV	VOISIN
AMLOHLIKRDNLRNIN	BION-KEROUEDAN
MSFANNY	FANNY
WFOUQUETLLLLILLL	FOUQUET
FJIFLCLICFLIULI	BORSES DEIINA
PUTIFFIPOURE	PUTIER - PURE
FAYOLLE	FAYOLLE
FLWUFAKKLR	EL MOUFAKKIR
SOLLNE	SOLINE
LYSPETLT	PETIT
WSEBDGYLIDVYY	SEBAG
IWJHIEIGWOWIW	DIEGO
DELLEEBA	DELLERBA
LEMALIRF	LEMAIRE
SMWALNLWIEIIWII	SALLIE
AMPLALLA	RAFAILA
GWWABNRWULNW	GABRIEL
RAUTUREAU	RAUTUREAU
BLAUCHET	BLANCHET
BEAUMLOW	BEAUMONT
AABURD	AMBLARD
AWKKAYANLLIVIL	AKKAYA
VERVHECKE	VERVAECKE
LUCLLE	LUCIE
TVOMOS	THOMAS
LOUIAVW	LOU-ANN
LEROY	LEROY
MMIRLRELPVAUIJNUOYJN	LEPAIN
W	ARTHUR
CORLNTLW	CORENTIN
ALYCLA	ALYCIA
NFCOLAS	NICOLAS
SELALIAT	BELALIAT
ALEXIS	ALEXIS
AIHE	AIME
EMWWNLSWENM	EMILSE
LWSAHTOILNE	ANTOINE
HWWONRWWTHW	ELORENT
CLENENI	CLEMENT
IMLLLSLYBLLOVKVTOLTLLLNI	BORTOT
DWJPERIWEIL	PERNET
PSMALROAUX	MARGAUX
AWWCLLELWYVJILLYLV	ANCEAUX
MSGONCLALVESLL	GONCALVES
BMONTOVS	BONJOUR
AMWERNWWANIW	MERWAN
CWLHEH	GUILMEM
DMLEUSEYRE	DIEUSEYRE
HILEW	MILENA
UWKRLL	ROGER
WHONORFIHUET	HONORE MUET
WHWHTNTWEOHW	MATTEO
PALLLMD	PAILLAUD
SASKLURD	SAILLARD
CHARKL	CHARKI
FOUUUEREUU	FOUQUEREAU
MWLLF	NOELIE
LWMSTLRILEVVLRLELVILL	LIEVRE
MMSTMDEIUHDELVLOUVLV	DE MELO
LINA	LINA
LMMSRMPLILYRVFUZVLVVI	PIREZ
JLBBVNETEAU	BRUNETEAU
DOURNA	BOURBIA
TYOMLL	TOM
WSROHFM	ROBIN
WXAN	RAYAN
TWMAN	TEOMAN
JOLY	JOLY
LEHLINAGEQ	LEMENAGER
JISSICA	JESSICA
PSCEDKILC	CEDRIC
GWULILLIWILINILLLVL	GUILLIRMIN
HAO	MAO
LOREUA	LORENA
LPCPRLLMWT	PRIMAUT
HEM	ELENA
PLDIEINLJIAMLENILIWLB	DENJAMIN
AINNE	ANNE
AURELIEN	AURELIEN
MMBMWILWENW	MARIE
PSROBFINILIWIL	ROBIN
SOCWRDI	SOCHARD
LAURENT	LAURENT
PLYOLHJAUNLESL	YOHANES
LANCIEN	LANCIEN
KEROUE	KEROUE
PSWPTLIISIE	BAPTISTE
NLYSSLA	ALYSSIA
FCSOLAS	ACCOLAS
JMWVLNESWNW	JULES
ETHHN	ETHAN
WIGUILLAJYE	GUILLAUME
TYOMBALLF	TOMBALLE
FWIINONUMVUVVL	PINON
AWIHNUHWUEHIL	ARTHUR
CWOLLNVYVVLIL	COLLAS
WSHRTHUK	ARTHUR
WYUDIN	GAUDIN
ROMAEN	ROMAIN
LENHLIN	LENAIN
PSHUGO	HUGO
LWICLAVDE	CLAUDE
NEJBRLL	MESBRI
XMGOSLVLJNJR	DEGOS
LEONLE	LEONIE
WSLISON	LISON
PMN	PETIT
VWRGENT	SERGENT
EBNLFW	CREMI EUX
MSWL	BENJAMIN
USUBELLI	USUBELLI
WIMANON	MANON
PSBDRDNE	JHRDME
WLMAZPENMNECVJLVIVIL	LAZENNEC
MYAILLARD	MAILLARD
WHARION	MARION
MAWNNMAWNW	ANNA
VSUP	YUSUF
DAVLID	DAVID
LUCY	LUCY
HAYW	HAYETTE
CORSELLE	CORSELLE
JADF	JADE
IADE	JADE
TCURIINE	TOURINE
NWWELVVVRLLLL	NOUVEL
WWAM	MONCADA
MH	BOGOTTO
HRA	ENORA
VLCTJP	VICTOR
NLICOLAS	NICOLAS
GWERVAISL	GERUAIS
UFNDAELE	VANDAELE
MYCTEVLLOVWYNELIVUV	ELODIE
DUBDSC	DUBOSC
ZJIYU	ZHIYU
ADEM	ADEM
JULIIETTE	JULIETTE
ELAAROUANI	ELAAROUANI
PUHG	PUIG
YSCLERLC	CLERC
JLPUWENE	JULIETTE
IHAFOL	IMANOL
WUBBNACQ	CABANACQ
WSEMILLE	EMILIE
LWYZTCMOLWLLSLLVVL	COLAS
VIANNEY	VIANNEY
MSSOLENE	SOLENE
LMYSTFRSNLALULLLTYJVV	ESNAULT
MMSMMDNILULDYIINJUW	ROLLIN
SITELLALLL	STELLA
TDRTET	TORTET
RFFIAU	MERIAU
AWHBELLUILTILLLL	ANGELOTTI
ALDELLAJWLJ	ADELAIDE
ETLNOVSSAOUI	ELMOUSSAOUI
LPSUORA	NORA
MMLOUNZWSENW	LOUISE
ALPNOELFQUE	ANGELIQUE
QNILLE	BAREILLE
WSTHFO	THEO
LPLBONNEFOND	BONNEFOND
HMUVETVVVVYVUU	HERVET
HARIE	MARIE
WMIMMNRSULDTTODTSSRTH	DEIRORTE
LUCIE	LUCIE
RWWXFMNWENW	OXANE
PSLHANLGLYON	CHANG-YON
FLMABIEN	FABIEN
LCWHIAURWAIJ	CLARA
NWLHELLVE	HERVE
AHELLAL	AMELLAL
MMSPMGLIOVPLPJXCVUJF	GLOPPE
HELA	MILA
HWAU	MAEL
WMSRMCHIAVUYFTLLLVJN	CHATEL
PADTOLLFAU	PADIOLLEAU
OCIAVE	OCTAVE
HAXHLJAJ	HAXHIJAJ
WWMELNLWLPUZVLOJJNI	GUENDOUZ
HEMEUE	LEMOINE
WMASSOTVVLYIVVL	MASSOT
FLRPLON	FIRPION
MMLYNVLHXWVVU	TRIOOX
MWWRELILILLV	DEBOURSE
PSMIALELILLEI	MAELLE
AMAUWJC	AMAUDRIC
UVLGU	HUGO
MSWIF	IDRIS
PARENT	PARENT
ELLSE	ELISE
PIILWIAWIINHTIINWLU	SAVERIA
MMSTFFRVULLHLLLIJVLVFLII	FRUHRUFF
WSANTZNL	SANTIN
CELQA	CELIA
VLVUT	VIVOT
HWWAFMFWEPFAOW	MARIE PIA
IMANE	IMANE
HATHIS	MATHIS
CMMUNTWRFHW	CLAIRE
PSIOISIFLPHLLLL	JOSEPH
PIVILLTJOKL	VICTOR
PSBQFEVCI	BRIEUC
ALBERQLULLLA	ALBERQUILLA
REML	REMI
WLASSJA	ASSIA
MAWRHMAWNDAW	ARMAND
NERLNA	MERINA
EME	EDME
BRILANTZEFFICECIW	BRIANTZEFF-CECILLE
LRDUII	EDDY
WSLBOLULKLLALCLLLHL	BOUKLACHI
EDOUARO	EDOUARD
MLWFNNAWHM	LENA
WSVLBEDLUE	VIGEUILLE
AOUET	ROUET
ALLBERTL	ALIBERT
JBVLLEN	JULIEN
NAYD	MAYOT
YWEJIT	PETIT
WMNCNAWRIM	OSCAR
TLIPHWHEE	TIMOTHEE
WJJFKFH	SARAH
WMSRGMALFVLFOIFVEVVLLJIL	GAFFORELLI
ETHAN	ETHAN
MMOROIIOPE	MORARILLE
MNON	MANON
QUENTIN	QUENTIN
LPITEO	TEO
LUCY	LUCY
MWLMTWFSOFTSOUIWLGDXLLUCY	TESTU-HALLEY
PSHUCO	HUGO
YWAXGQBBBERARD	BERARD
PLWTEO	MATEO
NWWOLMUWNNW	NOLLAN
HILA	MILA
AVELLINO	AVELLINO
PSFCIIEYPE	FERIEPPE
LLWLFSFMMVLVLDLTLVVVUN	MULOT
UWNEURLYLLL	LEHEUR
VLGWEAV	VIGNEAU
WWNNULLLLL	DANJOU
EVDAERI	EVERAERE
MAWJENLDIEIW	AZELIE
STEVEN	STEVEN
PLSCIHAPLTIEAUELASELMDI	CHARTIER-ENSELMOZ
PIDORIAN	DORIAN
BEYSL	KENYAN
LALUYRYW	LAURYN
UARW	HARDY
WBADENLWENW	ADELE
PIRFNANI	RENAN
IMICHALBEALULDLVLIEL	CHABEAUDIE
LWEIREJLLFLLFLLLL	ERELL
LWIPAULLU	PAULIN
MSJUSTINE	JUSTINE
WLLI	KOLLI
PSALJN	VICTORIEN
DWEBEUNEULILLLLL	KEJEMNE
LWSKEVEN	KEVIN
AUQE	AURE
PIASANULENLNONNJMMIIW	ADEL
NMSTERFT	TERFI
DEPINE	MEPINE
MOLL	PAOLI
LALLWPM	ADAM
NHEL	MAEL
CLLAYZA	CLARA
UEHDI	MEHOI
WJLOULS	LOUIS
LWSCANNZZZO	CANNIZZO
CALHYTLLE	CAMILLE
MWMXYLLLLNL	RENOUX
MSVALFIWLLN	VALENTIN
MWSRRMCIIWKPVCILLXWCVJL	RODRIGUES
MWIMDMUIVPFBYULRLYYFJL	DUPEUBLE
FLOIEN	FABIEN
MSLSALHWLULHVYV	SANTOS
VWALLEVLULLILR	VALLE
LWYHIIVYVL	LOQUET
LWSEJSA	ELISA
HAW	HARA
LWAKTM	WAKIM
NPEADNAU	PERDREAU
MAHU	MAHU
MMSMZMEIGYHLLKRLXLYYL	ZEGARRA
PMSTALLALLVTUPLELFLLIL	MALTREF
MANRDBFYILI	DOAN-PERRI
WSPIFPPF	PIERRE
LPSYOLLJ	POL
LINCOT	LINCOT
CANDILE	CANDICE
PIECHEL	PIECHEL
WMLMMHOIUUMOJEYDIVJJY	HOUMEAU
PJJSNAZLIIWIW	ISMAEL
YIVLENT	VINCENT
HOUNIA	HOUNIA
PSSARAH	SARAH
GYATNTRANO	GAINTRAND
WIUNVALI	BONVAL
NESKLNE	NESRINE
WPLSMFIDVUYGYZRYHONDUXL	BEAUGRAND
WLWAUMRWETTENW	LAURETTE
IILLILJEL	SCHEUER
JULIETTE	JULIETTE
WPSNNF	CHRISTINE
WSFLORINE	FLORINE
MARGOT	MARGOT
LPIISYAXLLHIEHNMLIM	MAXIME
PSPAVLIINE	PAULINE
BENJWFN	BENJANIN
HWIWNTEUIWUSEIW	MARIE ROSE
NARTUS	NARIUS
PSLEA	LEA
ZW	ZOE
HAQTEN	MARTIN
HWWFLMEWNANM	MILENA
LOLSEL	LOISEL
LULQYE	LUCIE
WSAARCIANTOIWE	MARC-ANTOINE
WJWVLNLWKXNW	JULIEN
BARMES	BARMES
OWSXEN	REN
NWLDANBFIWSONSOL	DGAMBI NGONGO
SEVJFWN	BENJAMIN
MLWTTL	MORETTI
CYLLAN	CYLIAN
SEYMN	SEYMEN
TON	TOM
ELLJL	ELOI
HSAILLWILTL	AUBERT
LAOVLE	CAGVIE
WCOLINLLLLYLL	COLIN
MWWUNWTEIW	NOEMIE
JUBRULLE	DUBRULLE
CLANTAGREL	CANTAGREL
ACLESCOLANO	ESCOLANO
FGRDAW	FIRDAWS
ULMRALLLE	CORALIE
WTSRRDLVHVFJNLOJDLVL	BETHENOD
YALSYEMTN	YASEMIN
LWENPEREWLLLVV	LEMPEREUR
BUI	BUI
BMORTH	BORTH
LEWTTEVIN	LEPOITTEVIN
PSEIWINL	EWEN
WLEMILN	LEMAIN
PSFOUIAUZD	FOUCAULD
WMET	BOUTET
MSLJOULMVLEYUJVL	JOUBLE
PISXLCHNLEIINMLW	LOANE
MRET	MORET
MLFLLW	JALLADE
YLLCOTIKIELBASA	VILCOT KIELBAS A
WSARNDUN	ARNAUD
CLWASSAWRA	CASSANDRA
CKETE	CRETE
LWLFELBOFFFYLYLILLL	LE GOFF
RMWATTWEOIW	MATTEO
MMSMMVFIVELILCUSA	VER
UANUH	MANUEL
MMBYHWAW	ABY
SMMAJVXGLMABDVJLLYULV	SAINSARD
UUILLAUD	COUILLAUD
MMSPZWAIUPAXVTAVIHVUEVNTALIY	ZAPATA-METAIS
TIWHHONMHASHIW	THOMAS
NWLLCLLQLVIYTYILHIVVV	JACQUAT
WIJOAN	JOAN
PUPLED	RUPIED
DLLANE	DIANE
WSVINLEHT	VINCENT
BEXTFBNO	BERTAND
RLVTERF	RIVIERE
LLYLLC	LYDA
LMWSFERLUVALHLDVEPZLLL	FERNANDEZ
HWHHTTZVQVLVLJV	SCHMITZ
MMIMLMNLOURBOAOILOLJYSAYL	CONCOULER
TPHOMAS	THOMAS
YWAHLLAOULLUUVLNLJN	YAHIAOUI
MMURCEY	GEORGES
WMSRVUNLYDELRUWLOLOLDJL	UNDERWOOD
LWOISYLLLLLL	LOISY
WM	BACQUEROT
GWBAHOULLLLL	GBAHOU
BCNWTT	BONNAT
LNWMSTDLLELLVALUVNLEUUVL	DELAUNE
MWSMWNLDYHAHTBDTH	DURMAZ
NOVICL	NOVICE
IIIIIIILICWPWM	COOPER
VPLUDUIYENER	VLUDAG-YENER
CLARA	CLARA
LWIJ	LOUIS
EPUEN	EWEN
AXEL	AXEL
IWNALLH	NINA
MSUEMENTILNG	CLEMENTING
LWMSTORULUDUJYJLJNR	DUPUY
LTSDLEGFSIOJLRS	DEGISORS
WSHUOO	HUGO
NAJSIFL	NASSIM
PISHELLY	SHELLY
WWHAXNSWHCHM	MAXIME
DWMUMLLMRVJJYTLJJY	DUMONT
LMPME	LAPEGUE
LPOPESMDLIVEIW	LOPES DE OLIVEIRA
MRIBZOUK	MABROUK
MMLTMFRIVONJOVDWJJYI	FROMONT
HETRAL	METRAL
CLLET	GILET
TWGFFAM	TIFFANY
ZNXARYA	ZAMARYA
DWIERSTEIH	DIERSTEIN
LLPLLENHY	LENNY
PLADALMILCLA	DAMILOLA
JJILJJNF	GU LLAUNE
FLL	ALI
BROCUET	BROCHET
FINIS	FINIS
VLCTOR	VICTOR
OORIAN	DORIAN
HANLHEE	HANAEE
CHABHA	CHABHA
BOURGEOIS	BOURGEOIS
AWWNLNSWSANW	ANISSA
DELBOS	DELBOS
WRRCZYWSXE	BARCZYNSKI
LFSLUZENLIKIO	LUZENKO
WMINWUSOLISDGUWOZO	THIERY
WMFAMMWNURCW	FATMANUR
PSMIATTHLIEU	MATTHIEU
FMSROLLAND	ROLLAND
LMMITULVDLFIILDLILLLRILJLPL	MARCASSUB
UUMH	VICTOIRE
IMSLLLECLELRJVFVLVL	LECERF
LBMEHOIT	BENOIT
PLLWUIIL	LOCK
TAYBUNUA	TAMBOUR
LMUWEVIVLLNP	LECONTE
MOLLEMMWENTNW	CLEMENT
LLLUPDIVIUE	LUDIVINE
ATILA	ATILA
WIYACTNE	YACINE
MMSMMCAIVVJLIIJDRYDLA	CAULIER
TMHIBAVD	THIBAUD
KHUOGAOUL	KHALFAOUI
NOEMLE	NOEMIE
IWSLGDLYJLLVYANHWLFUV	GAILLANNE
NILLOLASLLL	NICOLAS
MSWNITE	CLEMENTE
GPNGLOFC	GANGLOFF
CHARLOTTE	CHARLOTTE
POTLLER	POTIER
MMLLFSL	MILESI
PIJCNBM	JERUME
MIMOUNIMASSE	MIMOUN-MASSE
WEPHINE	JOSEPHINE
CONRAUX	CONRAUX
WPLMHAIVFIUONVVYUN	HARIN
LMSBFCHOUAL	BECHOUA
MRTUIAS	MATHIAS
ZWMSLWHNLRWWJL	CHERRAJ
AUSSEL	AUSSEL
WPPGEION	PIGEON
MAYE	MARIE
MLNHRT	MINART
WWCORNEWNTLLHW	CORENTIN
NIBHWIYWWEHIIH	MARINE
IWIWWLFYSL	DUBOIS
HIILA	MILA
LYIILOBJXUNNJUNONZWLOM	BRUNO
LAPDRIEN	ADRIEN
CELYA	CELYA
BIOR	BIOR
CLAPUCINE	CAPUCINE
ENHA	EMMA
LAMSLMAVUHLOLULVRVATVL	MAUHOURAT
CWAUDMN	CAUDRON
GABIN	GABIV
STNANO	STRANO
DAN	IVAN
MSRDNAWE	ROMANE
WEUVEN	QUEKVEN
MLCHEL	MICHEL
MIALBANEL	ALBANE
JASSJ	JASSIM
RUUJ	RYAN
MSINESS	INESS
DLEDO	DIEGO
MMFHNL	MENDI
NWSTEILXEIAAL	TEIXEIRA
LLILJH	TONA
GLNLBWT	GILBERT
DLEFHATS	DEHAIS
PSALQSW	ALISON
DELAHCHE	DELAROCHE
PSWHLMLULILIL	MORGAN
LWASONNL	LAGDAM
LWSBALLOUDROUSSEL	BALLOUD ROUSSEL
CHARBONNEL	CHARBONNEL
ELWLHLLLLLELN	EMILIEN
WSHUGO	HUGO
FNFIS	ANAIS
WLRDMOIOMLIM	BENJAMIN
IMLLLLSTILLNCLVHAVUISLPYELV	INCHAUSPE
PSJESSY	JESSY
IAM	IRAK
JLIE	JULIE
PSLOUISE	LOUISE
WPTISTE	BAPTISTE
CMADON	CABON
JLULLE	JULIE
LMWEONWIH	LEO
BOLLIC	BOULIC
BMJPELRRIIOILLLSLI	PERROIS
IMCGLEWT	GLENAT
YCHL	YONI
MWARLINS	MARTINS
WJLZZLLCLXLNLL	ZOZIK
FCUANPEHIIUEA	FOURNIER-SOLER
WVYH	KOEVYM
WLOLTRC	PENLNGAULT
CHHLNH	CHAIMA
PLCIELCIIILHELINIWIW	CECILE
WIISILVAHUVE	DA SILVA NUNES
PASTOH	PASTOR
CFLILA	CELIA
THALGA	THALIA
HLLLLSLGAVRCLVIALDHL	GARCIA
SWUSANLL	SUSAN
PLIEPRE	PIERRE
AGLHEU	MATHEO
GWOOAAOYLLLLLL	GODARO
LWSFUZU	ENZO
NLLFF	JOLIFF
RLFAAT	RIFAAT
MSAVAWYVLNILIL	SAVANI
WFBFZIIBIRM	NIBIZIGIRWA
WEWVAWW	EVA
MLXOUNAWNFNW	LOUANE
PZBUYVAN	BOYUAN
IWSLHVFIIKELLUHLYP	TREURY
NWIQELOYILVVLL	REBELO
HAXILME	MAXIME
MLWOUHLWSHW	LOUIS
YLLNON	MANON
MMSTVNOLQLFLVAUVLLIL	MOREAU
CLWLEHEW	CLEMENT
SARRN	SARRUT
AWUMLIE	AURELIE
PLLLSGIAIBIILINIILLIWIW	GABIN
NWWLCNOWLASAW	NICOLAS
MWZMMRCIVVEXRLWVTL	ROYER
DESLA	DESIR
CHSSAWDRA	CASSANDRA
PSUUW	HUGO
MNFRLILFR	NERCIER
DECUIWFUOUF	DENIMOUT
UWISA	ELISA
IWMSTNROLLUSLSJEIYAVUUV	ROUSSEAU
GLAWS	GLADYS
MSLPLLAWNLRLNCLKLULJLL	PAWLICKI
SLTELMHLH	STEVEN
MAALNA	MARINA
WWSMLMLSNUDHXNIITNV	CHORD
LFSIKAT	LE STRAT
WWSSCVLLLIIJH	Rosso
FLEURY	FLEURY
WLHGDTHF	AGATHE
WSLWIANNE	LOU-ANNE
LPSDUTHOITIVAWHECXE	DUTHOIT VANHELCKE
NHGWCW	JAMGOTCHIAN
SLLSCVATH	SISOVATH
TWOURIEA	TOURIER
JOUVE	JOUVE
PJCHARLOTTE	CHARLOTTE
IWNHWNBCWIH	FRANCOIS
UMIWELLVYLLLV	COINTE
BANONIO	BAMONIO
LLMSLCZLFX	LOZIER
WZDUVLALRLLLT	DUVAL
MARZOT	MARIOT
PLZIILLJILILZIIIAIIWIM	UC
NAJDA	MAJDA
ASCLEMENFINE	CLEMENTINE
PSLEA	LEA
WSBQICE	BRICE
LWEFEDVXF	LEFEBVRE
UYYXMELLIU	HYSENBELLIU
WSAHRFU	AHMED
PSWIINUOLILONG	MINGLIANG
WSADNANE	ADNANE
RULLEA	MULLER
WWWHWHW	LENNY
ESTELU	ESTELLE
NYRIAN	MYRIAM
SHWA	SHANA
MJSULIE	JULIE
PAILLOT	PAILLOT
LOUZS	LOUIS
FWLLINEERWLLL	FLIN PERON
NML	NAWEL
BFLARFF	BELARBI
LPSTILAWL	TIAGO
TLOMH	THOMAS
NMSVARLLLCALULTLHALOFE	VARIGAULT HALOPE
CFDRIAN	CIPRIAN
FLUH	FLOCH
IMSDUCORLHLELTRL	DUCORNET
VEWLEW	VINCENT
JMWJNEWAYMW	JEREMY
DUCLFUNL	DUCLAUT
GUEHENNEUX	GUEHENNEUX
ZOE	ZOE
JMMSRLMALVBEVRVIVJN	LABERT
PZBAPTZSTE	BAPTISTE
TOH	TOM
MEURLE	MEURIE
WRENA	MORENA
WSANTONLN	ANTONIN
BOEJHEBEUR	GOETGHEBEUR
NATER	MATEI
BADTLIEN	BASTIEN
BORLFS	BORIAS
JULXNE	JOLYNE
TMWW	FOOLON
CAZZMO	CAZZATO
MSLKHYALLDLLLLLLLL	KHALDI
MSCLLLOUYPCKEI	SCHOUMACKER
MMSPCMAIVSAJYLODTLLYN	CABAYOT
LWSACKELRL	ACKER
LWTLLIHX	WILLIAM
HOREAU	MOREAU
MLLMOVNTIAVNLEVRVLH	MONTANER
LYWSOMUIDUNYOULUGRWIJ	OUADOURI
CLLE	OYBE
PSJADE	JADE
WFWNLNELLLL	FONTAINE
MLNE	MARC
LPSOAMLEN	DAMIEN
CWMUNWEWAM	CLEMENT
MSWD	ELEA
HORTENSE	HORTENSE
IWSKRAFEM	KRAIEN
SAEZ	SAEZ
SIHER	ESTHER
LMMSMHMDIQUYRCSULJHLLLVL	MARROUKI
LEPEU	LEPEU
CHNTANAY	CHATANAY
DAMLFN	DAMIEN
SWWOUMAWDMW	SOUAD
WSJSC	LISE
WWERVIIVYLRL	LECUYER
LJMSALAUXL	ALAUX
LPRYAN	RYAN
WSADRIFN	ADRIEN
WMJHCNHWAIW	SACHA
YSALZAU	SALZARD
TMHHONHWASAW	THOMAS
PHYHN	LAYAN
PSWWIEL	GABRIEL
LWSJWLH	JULIA
LECORRF	LE CORRE
WIFLHLENAN	THIENAN
TABLOE	FABIOE
LUCAS	LUCAS
WMSRDMEITVAVNHVIJNVGD	DEJARDIN
GMCPGAULTLL	GERBAULT
NIALFXFS	ALEXIS
PILSAALDLIIILLJVY	SAADI
WILS	NILS
MWCCMUSUFOLUYYOSH	GEST
WWLUKNAWSNM	LUKAS
CMHAQBLEBELLL	CHARRIERE
WWWMW	ADEOCHOUN
NSBABLRLERTEALURL	BARRETEAU
THJOAUT	THIGAUT
CWOUSIN	COUSIN
WWRALULFLMDSVJOUWJD	BEAUFILS
LLMSLAURE	LAURE
OELANFRZELLE	DELATARZELLE
CUWELJN	GUIZELIN
URCIUOILWI	GREGOIRE
PSTHEO	THEO
MARLNTE	CHARLOTTE
IWLBAULDLRILLN	BAUDRIN
TOKNAK	TOKMAK
LAMLLTOLRYRELSLLVVL	TORRES
EYSTEVE	ESTEVE
SMOUANEF	SOUANEF
AMBRGHAH	ABRAHAM
WSSLMON	SIMON
CMWFEMNWEMNW	CLEMENT
EHILLAM	EMILIANA
ALAVOLNE	ALAVOINE
MMITBRALRYRLEVTLELAVUVI	BARRETEAU
ELACTC	EUCACIE
WRFAM	MYRIAM
LLLAWLY	LALY
LMMSLELONG	LELONG
THODAS	THOMAS
PLLCOULSSEDEEM	COUSSEDIERE
HLOXLNF	MAXIME
PSGBDLELOIXL	GEDEON
ALEXLS	ALEXIS
FNIDAIWUR	FATIMA-NUR
LESUR	LESUS
WMSRJMEIVAUWLVLULL	JEAN
UA	EVA
WSTOM	TOM
WDZVNVDECHOUF	MURZVN--IZEGHOUF
PSVIMENTLHJ	VINCENT
RMIZULURES	RIZOULIERES
WMHANE	ROMANE
PIIZLIANVNRIENANLNWIIW	LAURE
GULLLOT	GUILLOT
NWINA	NINA
NCLWENV	NOLWENN
NDA	TONA
AUAM	ADAM
PIILRLEIMLLIIILINWIM	REMI
HSCOLINE	COLINE
WULWIRF	BOULDOIRE
SWIUULLOUX	HULLOUX
HMWELMIWSSANW	MELISSA
WMCRAY	DUCRAY
LMLJEAVNIPLERRE	JEAN-PIERRE
WSLOULISL	LOUIS
PIISAIINTHOLHNNIELNHWIM	ANTOINE
PSCHANTAL	CHANTAL
GLPANANCE	GARANCE
MFLANLB	MELANIE
ELODLE	ELODIE
VWLWLTURFANLNLJN	VENTURA
JLWL	SBAT
WSISCIANE	ISCIANE
FELICIEN	FELICIEN
BWODEVEULLLLL	BOSDEVEZY
AMSLHLLVXALNIVDPJCLUORLREVLA	MIRANDACORREIA
HALNFIN	MATHIEU
SOUKUDIH	BOUKHDIMI
RVYBLEN	RUBEN
LWWLGAULLITLLIELR	GAULTIER
AMLAYNDINS	AMANDINE
AMWMMAWNW	ANIA
YASSLNE	YASSINE
TIIZIAW	TIZIANO
UWILBOVLPGLELOILS	BOURGEOIS
ZAHNATL	ZAHNATI
ULLLNLLALJ	NICOLAS
WLLLSLJBVOLUVVRELLVLNLIL	BOUREL
BLZEAU	BIZEAU
LVANA	LANA
PSZOELZINELILIJ	ZOELINE
UFHROUG	DAHROUG
LMMUDNILWVLNEHM	LUDIVINE
MARMN	MARRON
ITWHRINSLTLANL	TRISTAN
MAKLE	MAKELE
MWORGUELLVYILVY	MORGUE
GMENNAROVULJNU	GENNARO
MSLPDIVCVFLYVVVL	PRICE
JLOULLIM	LOU
GIBLIER	GIBIER
LEOST	LEOST
WCLEHEM	CLEMENT
DHNNAW	HANNAN
LLASDONON	DONON
WLMBMAH	DEBORAH
MALN	MORIN
ELNA	ELISA
FFFNCOU	FRANCOIS
BWEGHSCHELIJVJUVD	BEGRICHE
WSHTMEU	MATHIEU
LTJHYPAQLE	THIEPAINE
MILLESS	ILIESS
DOVOVAN	DONOVAN
MMSMWMIUHUFXNIJ	ROCHF
COLAWCCO	COLACICCO
WROGER	ROGER
AILAN	ALAN
SWNEX	SEYMEN
RTLER	POTIER
WSHELLNE	HELINE
DFRRUAU	DERRUAU
ZOE	ZOE
WCHUCHELLLILYLL	CHUCHE
PSHLILLIOJZ	MILLIOZ
HLAAYINE	HARINE
OWLSWER	SUTTER
SARAH	SARAH
IRLIYNA	IRINA
IHENTOVF	CHENTOUF
MWANVNTWNEMW	ANTOINE
MILUCIE	LUCIE
QUIGNCN	QUIGNON
WMSPTVCLYHUILELNJJIEJLL	TCHUENTE
LEWNZO	ENZO
IWIDUGLLELSILASL	IGLESIAS
YANNES	YANNIS
ALNTYONLN	ANTONIN
LWLELSA	ELSA
ROHIEVX	ROMIEUX
WILUCSE	LUCIE
AVIAN	ALAN
PWW	PIERRE
DANTLN	DANTIN
WCWLFNNWENTIVENM	CLEMENTINE
DANA	DANA
PIIISJIIMLOWOLHLMWIVM	SIMON
WLLEO	LEO
PILAHBERT	LAMBERT
LPSGABIN	GABIN
WLCORENTIN	CORENTIN
EPYSA	EPYSA
NWAOZH	NADIN
FWOURNFER	FOURNIER
NMCBIEINIELRI	BEMER
TWRECALLI	TRECA
LLPLELELCELIYULVE	ELICE-BOUVE
UEYRJHCK	NEYRINEK
REWAULT	RENAULT
PWASTRELLLLVL	PASTRE
CWHEREUETLLYLLSXILLLYU	CHEREMETINSKI
SARTOU	SARTOU
ROULENQ	ROULANQ
NLMATHAN	NATHAN
ROCHETEAU	ROCHETEAU
DAUDJ	BAUDET
WWDEGM	BERDEGAY
WPWEFMRWLNENM	PERRINE
MLESEURRE	LESEURRE
WSLPHLLLLYLLLL	PHILY
OUFNTTN	QUENTIN
LUCAS	LUCAS
PLMARW	MARISA
CWLAEYSLL	CLAEYS
MSLOPOYLLYLV	LOPEZ
THCMAS	THOMAS
DONDONIBOGOSAV	DONDON-BOGOSAV
CODNU	CORNU
MUWWNWWAAM	LAURENA
EUSLACHE	EUSTACHE
LLPIIIHLAIULRHEILCIINEJNMLIM	LAURECINE
XLHOMAS	THOMAS
QSFACHA	SACHA
FLP	KAIS
WSFUELLNE	EHELINE
JWOULRNOVJLIVYLL	JOURNO
PSGUERY	GUERY
KVLLYALU	KYLIAN
ITTI	TTI
LLPLAVEWET	AVENET
LLHIVIAIUFGIONL	VAUGON
ELOI	ELOI
PSALLXLL	ALIX
LVALTICRF	GUALTIERI
MWWNWWILWHMI	BENJAMIN
HATIC	MATIO
NWITESSIER	TESSIER
WMWTNHWUKNW	ARTHUR
WWIMMIISIDISDIIOIOLYDLL	LANOIS
NMSDUBAXRYL	DUBARRY
AWWLLLVLVIV	ALZI
LWLLGUIYLLLLWNLLL	GUILLOT
WSALYCLA	ALYCIA
HATAILOE	MATHILDE
MWLKNL	MIKAIL
CHLOE	CHLOE
PSFANHY	FANNY
MLSSEYTLLXY	MISSEYTICKY
ECE	LOE
LEFAANL	LEFRANC
IMLKLIEFN	KLEIN
WGBIMX	GRIMM
MEMW	MERWAN
ULLPWDA	MELINDA
ALISON	ALISON
BONNET	BONNET
XFRYALNE	KERYANE
LECERF	LECLERF
WPAREVTVE	COMPAREOTINE
YSILLJUULJ	CHOUQUUI
MSLSCVHULYOLVEUUALU	SCHUYLER
HLLGRELLATL	GRELLAT
GMSRZJBLESFO	RIBEIRO
HWFAMANS	HERMANS
SIBHOPUMULEJIH	SOPHIE
CLEHFNTINE	CLEMENTINE
AMSCHOQUELL	CHOQUEL
EMHA	EMMA
HELENE	HELENE
MMSMMCOIVUSLOLLNVUJJL	COUSIN
FMAUVANLLLNDLI	FAUVART
CAUCHET	GAUCHET
CHADOA	CHABOH
PZOUFLLLLON	GUILLON
LASAHICIA	ALICIA
BONTELAEF	BOMMELAER
BLAUCARD	BLANCARD
TEDDY	TEDDY
CILEMN	CLEMENT
IMSBENALCLLHOVTAL	BENACHOUR
RDUSSET	ROUSSET
DWMEBWAFLWHOUVOVILNIU	BERRAHOU
JADE	JADW
HOURARD	MOURARD
LWSLSOLNL	LISON
BWWHASHIVWVNVI	BENHAIN
LHALABI	CHALABI
LPIMLANONLI	MANON
DEBOMY	DEBOMY
MSSYLNANE	SEYLOUANE
MLWWMLWEHM	LUCIE
WLPIERRE	PIERRE
PSFADLO	FABIO
MLYSTSLILOVRLVALNVOLLL	SORIANO
WLLLLL	LILI
WJBULMEWRRW	JULEN
WLEORAVERELNLDLL	LEGRAVEREND
JWAWB	JACOB
PELOSO	PELOSO
LPSBRON	BRON
NFTHLLDA	MATHILDA
MSEMMA	EMMA
BWVEWLYIYNUOVNJADNYL	BENSIMHON
LAHILLLLE	CAMILLE
LAURA	LAURA
WMCROU	DUCROCQ
PWNVTN	BONVIN
LMRLLMRLCYAVNILFLNBW	LACANIER
WLWFNMQWNW	LINA
HORTENSE	HORTENSE
MLVSFCLLRFLNILLFLRVLLJ	GRENIER
PLISITIEILIUIIIAIWLW	STELLA
LULAS	LUCAS
WELSN	ELSA
MARIE	MARIE
PLRAS	PIRAS
WWLAUNRWAAM	LAURA
MSXAVIER	XAVIER
LLMIOULILAWLILH	LOU-ANN
SUREL	JUREL
PAUL	PAUL
DZUHLLLYDVSSALLW	DEMALLYDESSAINT
JWSSYLLIUELSTLREI	SILVESTRI
MWRTZVYYVVVVI	MARTZ
HEUE	HERVE
MORGAWE	MORGANE
MLMAXIME	MAXIME
MHALN	ROMAIN
HMSKIVFEC	RIVIERE
PCELJSIIILLLLSLH	EMMA-LISA
PERE	PEREZ
MNWBLNCWONIW	MALCOM
LWP	MARVANN
BEAUFGJ	BEAUFILS
CHRLILOPHE	CHRISTOPHE
PDENDANE	DENDANE
WMSMNMAIVUFBLLZILTIVIUY	NAVAILLIER
MMSRTMALRVRTAITLJVDII	TARRIT
WMSMFMRIAVWTOJMVVTJSO	GRANDONT
FIEUEIREDO	FIGUEIREDO
BODILINFER	BODINIER
QUENTIN	QUENTIN
WSPAPHAEL	RAPHAEL
I	LAURA
LTWIHOLMAFSLLLH	THOMAS
WMWMNEWLLENW	CAMILLE
WLDAVLD	DAVID
JASNINE	JASMINE
HAELLE	MAELLE
YLWWANLU	BENJAMIN
AAHINLLAVAL	MARTIN-LAVAL
LELEYLOU	LEELOU
LWSCWFFRFY	CEOFFREY
INES	INES
WSCHLOE	CHLOE
BMLRNCCLRVRJEILWAJVR	CORREIA
MWMAJLOLULLRVJWWUU	MAJOUL
HAXHLUI	HAXHIU
MLLAVM	DELAUNG
LMRSTVLLELJVFLXLVIVLIY	VESIN
MLAUGUSTLN	AUGUSTIN
MMSTDMUIPVRVEJLNLDJ	DUPRE
MLAW	NOCANN
ALFSSANDRINI	ALESSANDRINI
MLDELLALHLALLIFLSL	DELAHAIES
HAIVI	NAILI
WSDABLO	PABLO
WSLCUIS	LOUIS
THDMAJ	THOMAS
MMSTZMOIUVATJUIVVYJIU	ZOUAI
SIQMIINDUD	SRAMINDAS
ULYNCF	COLINE
YSRIAHII	RIAHI
WMANIP	MARTIN
AWLCASBAS	CASBAS
JENMCWLAK	SS
HYEZFANE	MEZIANE
PLJADE	JADE
MEYRINE	MEYRINE
LWLMACVA	MAEVA
MMSRSMCIHVFVLJLNFJVRVR	SCHELLER
MIALW	MIALOT
ZOPANI	ZOPANI
WIANBM	ADAM
DSORF	DJORF
NMSJAALALSLGELL	JARRIGE
WMSMMACIUEJITJXYYJA	ACETO
PSGRATTARD	GRATTARD
LLPJTAHBY	TANGY
MLEGAC	LE GAC
OWLIVJEKLPLLL	OLIVIER
ULDC	CALDO
PCSLNDX	SIMON
LMSLOU	LOU
IYILIIILNL	DELIENNE
ELCSA	ELISA
JLAUE	DCANE
THEO	THEO
MABWU	ABDOU
KEUY	KELLY
PSLEA	LEA
NZAE	AMINE
WWFLRAFT	WALRAET
HAWVTW	HARDUIN
FERRAXD	FERRAND
MMSMHMFIUVMFLUULVVCYIIDAUT	MEVEL-LF-DARZ
CWHENHLLLILL	CHENAL
CAHILLE	CAMILLE
MMSTHLLALSLVLVLELLFZVLL	MARLIERE
PULATLAYMKNSDLIKINNWLLM	TAYRICK
PWWAOMLWAAW	PAOLA
HNNNE	JEANNE
NARCON	HARCON
NUTLJOLL	NATHAN
MWANBJIOMPYLLLLLLLLL	MANGIOME
TMWAISTWDNNW	TRISTAN
TWAMT	TAMET
ELLE	ELIE
BPENAHADQUI	BENAMADOU
PSBASTLAN	BASTIAN
XLLOMYA	LOLA
PSVIXAI	VIKA
IWLLLTUI	LILTUR
JANTS	JANIS
MSHERVLE	HERVE
MSBIRACCALI	GIRACCA
HRBERX	BARBERA
DLIAYMANTIS	DIAMANTIS
NMWLUWWLASIM	NICOLAS
WQN	MORIN
ANCLIAUX	ANCIAUX
ELISA	ELISA
MARIE	MARIE
NWSLAFAJRLGUE	LAFARGUE
IBNLOAJLIHLLL	NOA
CHARLLNIE	CHARLINE
BWWAPNTWISTEIW	BAPTISTE
HOWNEAU	MONNEAU
LYSANDRE	LYSANDRE
MMIRBLLLLALWTCHNLVOLN	BLANCHETON
WHENRLIGUEVSLILNVY	HENRIQUES
DSLELCOLMLPTCLLLL	LECOMPTE
HLFAYDUXL	FAYOUX
NATHILS	MATHIS
DHEMRTOLI	DE BORTOLI
OWBCUMWNEMW	OCEANE
HTARE	MARIE
WWTEVYNWLR	BOUTTE
DEBOISANGER	DE BOISANGER
HLLUUO	MICOUD
MIRCHLL	MARCHAL
CHRLJ	CARLA
HHHEZ	RAKEZ
HIHIER	MINIER
WJANNAELLE	ANNAELLE
PSHWLVA	MAEVA
MMWADNLWIEIW	MADLIE
EMWSNNWBBNNW	ESTEBAN
SALMON	SALMON
LAUREW	LAUREN
CASSLIE	CASSIE
MSADAHLL	ADAM
PEAAFT	PERRET
MPSOPJLVUVOELRUYIL	OLIVER
NMSBALASXANTHAN	BALASKANTHAN
SERWA	SERENA
PSENIZOLILHU	ENZO
FMBANMNWYNW	FANNY
TWS	THOMAS
WMWGMRULMVUVMYN	VOGRIG
AEWR	AENOR
WSLSAVHTTOIYUTLILL	SAHTOOT
MSHIIVILNJ	HIVIN
LOU	LOU
ZW	ZOE
IWSLWLLXLUVIVVV	DOOX
LEOMTHE	LEONTINE
PJJOSEPHLNE	JOSEPHINE
MANYLIS	MANHES
UFS	INES
LMWOUHIWANNHW	LOU-ANN
LEA	LEA
CMHAIOMMOWSEAU	CHAIGNOO ROUSSEAU
LOHGEPEE	LONGEPEE
BOUTOVB	BOUTOU B
MILLILFALRLLLL	LIFAR
MWORENO	MORETTO
CHRDLLHE	CAROLINE
PSCIJLEOIPIHELELIWLM	CLEOPHEE
LTLIAH	LILIAN
HLLDESVFGNESLLI	DESVIGNES
WLHERLBLYLLYLL	HERRY
MFXSTNEWBANAW	ESTEBAN
CWWLENHWWCENW	CLEMENCE
QULLAW	QUILAN
LFFEVRE	LEFEVRE
WWLIOUMIWSECW	LOUISE
PWWLELYLLLLLL	PAULES
LBALXEJLJULIJ	AXEL
DDNIAU	DANIAU
LIWLLSTDLLURADNLDLJIUJ	DURAND
WHALNLLUEL	HAINIGUE
ROREL	MOREL
TRANCHANT	TRANCHANT
PHELIPPOT	PHELIPPOT
LLBLWLLLLL	LOU
WLLEOWARD	LEONARD
FALVREDIARLICF	FAIVRE D' ARCIER
WR	DUR
MWBFPNTWLSTEHW	BAPTISTE
MLCALLLLBLRELLL	CALIBRE
UURTJSE	HORTENSE
WHWEZMIWNWRW	MELINDA
MLILBOVUULVNERLULL	BOUCHER
MSDRLLILLARULDYL	DRILLAUD
JOHAN	JOHAN
MSLBUVTEVLLYYYVL	BUTEL
ROGKRLAUORLEC	ROGER LAUDRIEC
PIMLIAXLHEI	MAXINE
HWPMIAIGNAN	SAINT-AIGNAN
BAPTFITE	BAPTISTE
WLVLCTORLNZJ	VICTORINE
WWWNMWINERW	ANTOINE
WSLENA	LENA
FWWRWVALLLLLLLLL	FOURNIVAL
WRUCOLNL	RUCOIN
WJSHAW	SOHANE
DUBVS	DUBOIS
QMLVESTU	SILVESTRI
DUCOUT	DUCOUT
PAOLA	PAOIA
PHILIPPOTE	PHILIPPOTE
LPSWTLELALULL	WATEAU
LPSMLATLHIS	MATHIS
LLHMICHALFLPLEMLLIEF	CHARPENTIER
BIFAUDEAU	GIRAUDEAU
HSAN	KASAN
BMXBDENIFRLLLLL	MENIER
WELWIW	QUENTIN
NMGVYENLLLLLLLL	NGUYEN
WMWAXNIWMEAM	MAXIME
PSNARJE	MARIE
VMASLLJEVLC	VASILJENVIC
ZACHARTC	ZACHARIC
CLARA	CLARA
MWIMWLNJONSRISOASBNL	LARGO
CEILFA	CELIA
ESTJVAL	ESTIVAL
IWIMARLLILELNPLYL	MARLIEN
RYEVLFRU	PERREAU
MSBAUYTALNLTILLL	BRUYANT
SOPHLA	SOPHIA
MMJPTRALLUHOUOFUMUOURTHF	DAIGUEMORTE
LMSHARGANF	MARGANE
BICHAFD	RICHARD
CASSANDRA	CASSANDRA
LW	LEO
WSISAAC	ISARC
EOQAW	ROMANZ
RONEL	RONEL
PLHHFLOLL	KHEO
HWEIS	NAEPIS
NASSLH	NASSIH
SUMEYYE	SUMEYYE
ROBFRT	ROBERT
MXBRHAWYAHM	SORAYA
IWSPFUZLLLATV	PEUZIAT
WDET	BADET
WIAW	DAVIAUD
MRWOHAAWLNHM	ROMAIN
ARNFN	ARMEN
MMSMMLFLHVDYZDNQIJJLL	LEMAIRE
NLATYHAN	NATHAN
LEELW	LEELOO
RAYMONO	RAYMOND
ORTOLA	ORTOLA
WAWMMAWNW	EMMA
AWRPFL	ARZEL
MMSRAMNIUAJIFYUVLJLL	ANAIS
WRAM	SARAH
WUWOU	URVOY
HLLLILNAGLIELLLF	MAGE
LMSPORLLANLTLL	MORANT
DILNECN	PINCON
LWSALICIA	ALICIA
WLIAN	KILIAN
WSCIZHYLMLL	GEREMY
EWWVGMEWNFENM	EUGENIE
WSSHARON	SHARON
MNWAXNFWUENM	MAXIME
DAN	IVAN
SLHON	SIMON
NWDEXCLIILLL	NDEKC
MIWHAXLHNEHIJ	MAXIME
DWSTLISLSYLUTLL	TISSOT
LYETONDUR	LETONDEUR
WINARULN	MARVIN
PCUDEROUX	POUDEROUX
PSRABIA	RABIA
PIFLLSA	ELISA
PSTALRIDLVLELLY	TARDIVEL
PROST	PROST
LWWWNAJSBIIW	LUCAS
NGUYEN	NGUYEN
MLWLLIEA	MERLIER
MFWABHLWENAM	FABIEN
YSROLLANDI	ROLLAND
PAULINE	PAULINE
IMSIAWLVELVYLLY	FABRE
FWUHAROLIVVMVHIJ	FUMAROLI
MWWLBMLTNL	RANOUIL
WSLEA	LEA
QSUELWILLNIW	QUENTIN
MABXXULS	MARIUS
SELVARAMOS	SILVARAMOS
PSLEGUEN	LEGUEN
PSIRLLAINDEL	IRLANDE
MEO	THEO
WLLWEK	BOUVIER
SLLAMNUEL	SAMUEL
LOISEAU	LOISEAU
JWWLLLLLVL	MAGRI
TBRAHIN	IBRAHIM
WSRLATZ	MATTEO
FWNIUAULLL	FAZILLEAU
WWWENXULWSIW	ALEXIS
MMSRMULILPVLLLLYJILVYLLJBUVKFT	DUPOUY LABOURET
LOQUEN	LOQUEN
THELEWIN	THEVENIN
SWAUERLLLLLLLL	SAUER
WSWM	TOM
LMWYRNLWELLEHM	LYRIELLE
IWIBEKLRLILLLVL	BEKRI
MWDLSMLLYLVLU	DANCOISNE
HUYNHIVAN	HUYNH-VAN
AWHLCELLLLLVL	AMICE
MMBAYHHWLISHM	MATHIS
LANDHYS	LANDAIS
FERRONL	FERRONI
AUBURTLN	AUBURTIN
KFLLTW	KILLIAN
STFPHAHF	STEPHANE
MIELEONOBE	ELEONORE
PELLEFRLN	PELLEGRIN
MMSMFMAIUXRLUFUFLUJLNJ	FAURIEL
TPOP	TOP
JRNAM	TERNANT
BMLRMMIVEILLLINSCIYINS	DOVILLIERS
HMAVLRLN	MAURIN
SHAMLESLLE	SHAMA LESLIE
HAVLE	FLAVIE
DUSQAVM	DUGRAVOT
DUULGNYNURNLEA	JUVIGNY FOURNIER
PSANDY	ANDY
CENEW	CENEDA
NLLAHNA	ATAMNA
DILARIFLLLO	PICARIELLO
WCMAUD	MAUD
WIJAPCAND	JARRAND
LMSOSCAR	OSCAR
HUCO	HUGO
WLLHFFYBYOLHLELLL	HERBOMEL
FABIEN	FABIEN
DWNILYVLLLL	DETAIL
LOLULISX	LOUISE
PCSCPLRANSI	SOPRANSI
YWN	YOAN
MLFELIX	FELIX
WWE	OCEANE
ELLON	ELIOTT
LHSPTALLLOT	PIALOT
MGRANVLEXLENTL	GRANDCLEMENT
FOUSSET	FOUSSET
WUCHE	QUEUCHE
WIBAUNNYWWNW	LAURYNE
WSFNAELLE	ANAELLE
FACIAC	nan
SIWHARNAHHWIW	SARAH
WFER	OGNIER
HMSTHNULNVOTNLLVVYT	HONON
MPSCPOLLYOVMFDBYYNIV	COLOMBY
CALUT	CALUT
LOLLS	LOVIS
LELLNLLNGEBIPLVELLI	LEININGER - PINELLI
PSAHDRE	AMBRE
TWIOTYLLYLLL	FIOT
RWIAUSTWIYLLLL	CAUSTROIS
LLISYMMTE	LISELOTTE
WWWENLWLXENW	ENELINE
MSLILIAH	LILIAN
FERROUSSEN	PERROUSSET
WLDACVVHJOTLVLLP	PACHOT
FISCHFR	FISCHER
ELTA	ELIA
LILOU	LILOU
MMATNONNET	MATHONNET
DUPORGE	DUPORGE
BEX	BEX
WSFAUSTHF	FAUSTINE
HFTHUD	ARTHUR
LLPIISCIIHAIAILISISINMIW	CHARLES
IMSMARLNLLLUL	MARIN
NLATTEO	MATTEO
CAPWVIU	CAPDEVILA
KASELLA	KASELIA
GREGOIHF	GREGOIRE
ULAMVAE	HANAE
NLARTINL	MARTINE
MLIHANE	IMANE
NWCNM	MANEM
LOUNA	LOUNA
WMIRNDOLUSLLLTYJV	DOS
LWOUUANHV	LO-ANNE
SOUPEIJANON	SOUPI-JAMON
WHAHELILMLLLLR	HAMELIM
LLONA	LLONA
PLELOI	ELOI
UWMUMLWSCW	LOUIS
VANUERCUWDRW	VANKERCKVOORDE
EWU	ENOLA
PRUCHUN	PRUCHON
PALHNS	PALMAS
WWSMMRFSODNGBLNNGYGB	REBOLO
BRAYZN	BRAHIM
AWMNUNWIMHM	ANTOINE
MHCHARDIIMELON	MICHARDMELON
BAUORY	BAUDRY
DEGOT	DEGOT
WLNLLOLAS	NICOLAS
AINGELE	ANGELE
PILZSA	LISA
PAULLUF	PAULINE
ALLLMEXANDRA	ALEXANDRA
LPJINES	INES
WAXGELE	ANGELE
HSBONNETL	BONNET
RWRFVR	ROHRER
HLFIFLLLFVSLLLIFLLLLOLLUR	LESCIECCOUR
CWLIAMJILLLLEHLH	CAMILLE
LWSFVAM	RVAM
PSYSEE	YSEE
LFLCLAFAYOL	CARAY OL
WSCAWIHHEDIWIWL	CANDICE
ANLTLOIW	ANTOINE
IWLHALGALND	HALGAND
SLNAT	SIRAT
DEALHIIDD	DE ALMEIDA
KEKNLS	KERNIS
WEAXE	OCEANE
NTVMBAMXENDI	NTUMBAMUKENDI
JVLILE	JULIE
CORAZOW	CORAZON
MLUSMLNE	JASMINE
MMSMMPJIUDTNWN	PETIT
AAILFU	MATUFO
UHHIJE	HATHILDE
NYOAULC	MOALLIC
CARPENTLEP	CARPENTIER
WSKELLV	KELLY
WSCONSTANLE	CONSTANCE
FAMUJINII	FAUSTIN
FIABLILEIM	FABIEN
MWARTIN	MARTIN
WLADAA	LADAM
OMFTLINGEKLLL	OFTINGER
WSMAQIE	MARIE
HAXLHE	MAXIME
WLHAAD	GRIHARD
RCHAZLL	ROMAIN
TNLILS	INES
ANGELA	ANGELA
BHRLWO	BARRETO
SWIA	SOFIA
WSALBANE	ALBANE
CPANDLCE	CANDICE
UWMEFVUNMYL	DRAIEF
BERYL	BERYL
WLMALO	MALO
AALHUR	ARTHUR
THONAS	THOMAS
JANSANO	SANSANO
PSVLCTOR	VICTOR
PSOCEANE	OCEANE
MATHLEU	MATHIEU
LWSSAMANYNI	SAMANTHA
ZAKARYA	ZAKARYA
ULIU	COLIN
PSJULHLETTE	JULIETTE
PSIALLFXHIDW	ALEXANDRA
RWWE	ROSE
GAWLER	GAUTIER
SLLA	SILA
FWTSBRELPVUISUSYEJAVUJY	REPUSSEAU
MSLYSA	LISA
QUZON	QUITON
IMSTRZLTLSCHLLL	TRITSCH
PMIPNLELYYFAYOLUOVUL	LE FAOU
PJAAAELLLL	AMAEL
CCLLINU	COLINE
HATTHIFU	MATTHIEU
GFOSSE	GOSSE
SAMUEL	SAMUEL
WSLHFYPVPILNLLL	HEPP
SIALOHE	SALOME
KWOMAIN	ROMAIN
DLSLFHTR	LEHIR
CLEMEME	CLEMENCE
COURT	COURT
WSPAULLINEL	PAULINE
PSAAFON	AARON
MMA	GASSAHA
CHAUIMETIVFWLFR	CHAUMET-VENIER
MSHAHILLF	MANELIE
BRLZAY	BRIZAY
MMCPCMUIVUUMLUMLUVV	OUURARA
SCHOVYEFENS	SCHOUTETENS
LFUA	LEWA
AWLWWLLCWWL	ANNIC
LOLLS	LOIS
MLMANON	MANON
QGATAF	AGATAE
MCHWI	BECHAMI
DHFMIUE	AMANDINE
ALWILLJUHHIILH	ALICE
NOABAEEQA	NDABAGERA
ALVES	ALVES
LWRSTCLLHOLILLZIT	CHOIZIT
EINILIE	EMILIE
MRSFVHLVFLSAVYFLILL	SAFSAG
LMIUEPHLITALI	NEPHTALI
OAGZLI	ANGELE
FLAFPLINA	FARINA
LWSTUOUAN	TITOUAN
MPSFTFUVRPVJLNVVATVVLL	TURPIAT
MLAURELLFN	AURELIEN
HAROY	HARDY
CYPRIEN	CYPRIEN
MSCLLFNFNT	CLEMENT
UWWKANNWNW	OKAN
DOSISAWOS	DOS-SANTOS
PIDASTLEN	BASTIEN
LWSFLAVSE	FLAVIE
MPSO	HUGO
MWWCHEL	DEMICHEL
LWSAJILSL	AIS
PSEMNA	EMMA
ABWLKAUFL	ABDELKAMEL
ZWIMFRLVLYFLLLLLVEALUL	MERVEILLEAN
SALPS	SALIS
BLLSFCLAQLULFLTLLTYL	CAQUET
BYIZARTILIHON	BIZART-LIMON
PSJADE	JADE
DWU	OU
SAMEL	SAMUEL
WSALEXAHDRA	ALEXADRA
KELYS	KELYS
PLCHON	PICHON
BJWARUCQ	BARUCQ
LMBFSMIWENW	LISIE
JTEUEN	STEVEN
MAHSANLYLLIV	AHSAN
MARCEAU	MARCEAU
WSGFELLE	GAELLE
MMSRRBLLLLLLONLILLDLTLZ	BILLON LOTZ
CAKMAK	CARMAK
MSHAXLFS	HAYLIS
WWI	DEBO
VICTORIA	VICTORIA
UM	TONY
LCWZ	LOPEZ
JAHRAW	JAMRANI
PSYLOAINLNLIIHNWIH	YOANN
FMWLANVWIENW	FLAVIE
FWLIAW	ELIANE
LAHEURTE	LAHEURTE
RPOLKA	ROLKA
WWIMNMISOIINLAOOOUUI	NOT SURE
MATHIS	MATHIS
MVLTUCLVLLLLVL	DELTON
LASKOAAU	ROMAN
WSBAPTESTE	BAPTISTE
KRAWCZYK	KRAWCZYK
GALLWS	GALLAIS
APLHANDRE	ALEXANDRE
BOURWSE	BOURRASSE
PLADELLNE	ADELINE
COLINE	COLINE
WSALLJE	ALIZEE
IAPILE	MARIE
MSEVGWE	EUGENE
WLJULIA	JULIEN
WLLLSLBERTLLYONLELLLLL	BERTONE
DWELPECHYLRLLVVL	DELPECH
ABKAN	ABKAM
WRC	MARC
PJTHOMAS	THOMAS
PJMFCVLN	MELVIN
UYM	JAUNAY
MWWUMWMEMW	MAXIME
MADIE	MARIE
YCROANE	MORGANE
WMLMTWNSNONYLBILOOTJBA	TADAULT
LDMSCOUQUELL	COUQUE
JEAN	JEAN
CULFWLY	COULIBALY
CHRLA	CARLA
TMWHLINBDWULTNW	THIBAULT
FFWTA	FANTA
CLARA	CLARA
WLLZA	MILZA
RIIISISAIMIUIEILILNWIIM	SAMUEL
MWLPELLLLLLLL	LEMAIRE
KUCHENBUCH	KUCHENBUCH
SOUELHE	SOUILHE
MMSRCMAIVVBDOLUIDVBY	CAVROU
JUANICDI	JUANICO
WUNET	BRUNET
UMWNNSWEHW	ELOISE
KONQ	KONG
WMLMAMDIPUJRDNGSLW	nan
INATLAINIM	NATAN
SALOHE	SALOME
LLPULLILF	LUCILE
DUNOHCEHUX	DUMONCEAUX
MMSMMNIVRURBLCGZZUSLAYU	LAEORET
LWWISNAWNW	LISA
PLTHLFO	THEO
YPEPWIAU	PERDRIAN
APLEXANURF	ALEXANDRE
WSQLUAFN	SYLUAIN
WSIHONLLVL	SIMON
WSDENLALRLLYLLL	DEMARLY
WWLAHNLWLLEHM	CAMILLE
QWELLA	ORNELLA
LPSARTHUR	ARTHUR
APLTIHAWU	AIT-HADDOU
NWWOLMAWNNW	NOLAN
PIIJNLANUIMYNSHLIWLW	NAELYS
VPFDROA	PEDROSA
WSGIZCM	GIZEM
MMLTDNELJVELAVNLLLLL	DEJEAN
JULIETTE	JULIETTE
WIKYLLLAN	KYLLIAN
WWDHMAWNW	EMMA
LOU	LOU
NATHAU	NATHAN
NMEM	NEAU
HWOLQIUIN	HOLQUIN
FLRAFCX	TRACY
WWLONWWIM	LOUIS
IUOE	JUDE
MSJLLLLBN	JILLIAN
WKERAHPRAN	KERAMPRAN
MNWLMEWJNW	JULES
ANLGYELINF	ANGELINE
LAPORTE	LAPORTE
WSVENUSSGA	VENUSSIA
HOUSQVCS	MOUSQUES
MWWARMTWINNW	MARTIN
TOM	TOM
IWSLTAIQILLL	JACQ
WSHUGO	HUGO
EFEW	ELRAM
WEMMANUELLE	EMMANUELLE
LLMMSMCMAIWQUAYTIZUYN	CARRAT
CKAFDNHD	CHARPHED
HU	HU
LOUISE	LOUISE
WEOHGE	NOEMIE
DUUWE	DUCHENE
GABLRGELLE	GABRIELLE
PSUARCIAI	GARCIA
LLWSCLOITIHENET	COTHENET
IMSCAMCLUIYLHEML	CAMGILHEM
AFTIC	ARTIC
ALZIIIL	ALIX
PLVLIROIILE	VIRGILE
HELLENE	HELENE
LWIHPHLE	LOU-SOPHIE
LCWOLINE	COLINE
WTOR	VICTOR
MWORAISVLLLLLIL	MORAIS
MLLLSTRLLOYNTDEYALUYVVV	RONDEAU
PSALBAN	ALBAN
COWAN	COWAN
MENET	MENET
ALLOINLCOADIER	ALLOIN CORDIER
HUFDF	HULDA
DFLLEGF	DELIEGE
PJOCLEALNEL	OCEANE
OPSORLO	OSORIO
JWSLFQUEAE	LE QUERE
PSANGELE	ANGELE
PLHEIILYN	HEI-LYN
RILUL	DILAL
FWW	FLEUR
CJLJISET	CUISSET
LLYDYLIE	LYDIE
WSTLEN	BASTIEN
VHWLNLUEWWIH	JUCIE
KISMOUNE	KISMOUNE
LARURA	LAURA
LPSSWANE	SWANE
BWRULONVLILIILF	BRULON
NCLQ	NOIR
LANOERT	LAMBERT
DWVERLWLALYTVJWJRD	BERNAT
PLHARGAUX	MARGAUX
ALBAN	ALBAN
AMANNNE	AMANDINE
NOAH	NOAH
PIBEINJLALMJN	BENJAMIN
WWXLSLYVYLLYV	DUBOIS
WDMYMWRW	EMY
CUEDDOUBA	GUEDDOURA
WLBLRLIEILLULCILE	MARIE - LUCIE
LMLDALIUCHOT	DAUCHOT
MAMJ	MANON
LMWLAND	LACAND
TLANA	TIANA
IWBAL	IRAZABAL
HMWARNLBMIW	MARINE
ABAFFOUR	ABAFFOUR
NIION	NION
WSELOTSE	ELOISE
LRLOMNAW	RONAN
YSLNALIBYIL	MABY
LPSANALS	ANAIS
GHWUINIULWAURWEIH	GUILLAUNE
HATHW	MATHEO
MWS	NICOLAS
FABLO	FABIO
PSLILIIIILNLLIIWLH	LUCAS
MREHYLLLLLLLL	REMY
LIUNLLEHI	FONTUGNE
PSALIW	ALINE
RCBQER	ROBIER
CHOEUNG	CHOEUNG
AELNLR	ARTHUR
SYEOANO	SEDANO
SAMI	SAMI
FIEEFE	PIERRE
CHLOE	CHLOE
RAXFLHLC	MAXENLE
YSGERFAUDILVALENTIN	GERFAUD-VALENTIN
UWWEMWNW	EVE
GWMREMAULMDUJVOYUU	GREAUD
AHBRE	AHBRE
LELENE	CELENE
MATED	MATEO
CARPFNTPER	CARPENTIER
MSROAAIN	ROMAIN
BEAUSSLEU	BEAUSSIEU
HANELFJAOE	HANELEJADE
WIDAN	DAN
FLUL	ELOI
PAUL	PAUL
WWFBFRRL	WEBER
JWOY	JOS
DWENOYELLELLLLLL	DENOYELLE
WLTEANABAPTLSTF	JEAN-BAPTISTE
WNUVILLELLLLLLL	NEUVILLE
WJMATHIS	MATHIS
HLLOULFLSLLLI	LOUIS
NEHMUA	NEHAOUA
ROULIEB	AOULIER
LEMESNWER	LEMESNAGER
LPLRALLTIHIYIFNUIIWIW	MATTHIEU
SWEMNGEN	SEBASTIEN
VFRRLER	VERRIER
LOU	LOU
YANWIIK	YANNICK
CWWAAMLWAW	CARLA
DNSKJNL	AMBRINE
WSLLLLAW	LILIAN
RWAPAAEL	RAPHAEL
LYLLBOULVIERLL	BOUVIER
ULVLILPN	KILIAN
LUWA	LYA
BENWAR	BENAMAR
MLLLSTCHFVMLLIANVVIIV	CHEMLA
CHLOE	CHLOE
HWMAWNOWWNW	MANON
AWMEURLYLLLLI	AMEUR
WSLSETNTEILIXLVI	SETTE
WWVVLLLN	REDANT
YSSLILOIHII	GIOMI
WMLMFMLMLDILWGL	EVICUAN
PLCHAMOULEAU	CHAMOULEAU
JLNLLES	JULES
WSCNTN	ODIN
WWLWMIWSNW	LOUIS
RPEML	REMI
LWLBLVENEMLTVL	BIENFAIT
JUOLITN	JUDITH
PSROBIN	ROBIN
LEVILLER	REVILLER
FONTENEAU	FONTENEAU
LWEWEYIILLVLV	LECONTE
PSSOURISSEAU	SOURISSEAU
XWN	IWAN
ENZO	ENZO
SANTINLECAEA	SANTIN LE CAER
JMEVHYVILLIYIV	JENNY
MMLRMRLLPVIORLULVULLI	RIPOLL
JIMW	SIMON
MARLUS	MARIUS
RUE	ROSE
IWJLYLLAULIXALLVYVV	YAHIA
NIWHFNIWWHIH	MANON
MSNLCOLAS	NICOLAS
LPLSAHLEXILALWELIWW	ALEXIANE
ZAFFRAN	ZAFFRAN
CHARLOTTE	CHARLOTTE
HOHANEDNAJLB	MOHAMEDNAJIB
HARTET	MARTET
MLLLSLFMLFCNVDLMLALRLALL	MCNAMARA
NLWIOELNLLLLLLL	NOEMI
WSILOLSE	ELOISE
FLOIAI	FIORA
BMWARTVLLJVLYV	BODART
WMSPMMOIIVNNEVVTVILL	MOINET
MMSTRMEIGVNJLJEDRVIVL	REGNIER
LARZILLERE	LARZILLERE
HMLLE	MAELLE
ELNNA	EMMA
MANUEL	MANUEL
MWSMSMLIVATBJNLIYYYL	SLAINI
PLILAHA	ILANA
WSDAVLD	DAVID
MLLLA	MILLA
WSANWEL	ANDGEL
MMJRWTHIUVNUATSDGJJA	THOMAS
SPCHA	SACHA
ASELIOTT	ELIOTT
DURU	DURU
YAJSLLM	YASSINE
WSTLX	TEO
ERWHAN	ERWHAN
DLAPULLNE	PAULINE
WWROSMEWNW	ROSE
FLAGEL	FLAGEL
SWBARMWWNW	SARAH
AWM	ADAM
WSLLLI	LUC
MIEC	MAEL
GEPOFFREY	GEOFEREY
LMWUCNAWSNW	LUCAS
LWA	LENA
PIERRE	PIERRE
WLULRNRNLLNLIVILNR	PIERRE ALEXANDRE
PIXHOHAN	JOHAN
WVZAEWTLRLLLVLL	VINCENT
WMSMHMAIIULDTLAULYYLX	HAIDAR
HSCOHBRELLE	COMBRELLE
WLFLDWF	FLAVIE
MSBILAL	BILAL
WLXYLFD	KYLER
AWHSARD	HASARD
WWSRWMIUSNYOOUUHJFYIJU	DESNOUHES
WWMISMSWAHOW	WISSAH
HDUDUFT	MAUDIT
MFSSAOUDII	MESSAOUDI
THOMAS	THOMAS
LPSRAYLNAUD	RAYNAUD
LWAHCHACHTLIVYVLVLL	LAMCHACHTI
SUILLOT	GUILLOT
WSJOSEPH	JOSEPH
MMSRVLAUCRWODVTUXJUL	LACROIX
HWLLILTOYCTHEVIVTLCIHVLLVV	MILOCHEVITCH
MMSMYMAIUVEVLVYVYUL	YAUEL
WLADZMFR	WLADIMIR
ETLKNNE	ETIENNE
HWARVTILBE	MARVILLE
AMEL	AMEL
LMMSMAMWIVOHUDUUNONTOK	BEN HADDI
KRZYX	KRZYK
ILEM	ISLEM
NAVELLTER	NAVELLIER
PSDVLAN	DYLAN
WM	COLAK
DMUPUYLILVLLL	DUPUY
WILEYA	LEYA
OUSRINE	JUSTINE
DRSHAB	DASHAB
TPROCHALR	TROCHAIN
HAYAN	HAYAN
UISY	LOISY
MSAGATHE	AGATHE
BULLIFFON	BULLIFFON
PSELNF	EMMA
HARIANNF	MARIANNE
ESTHFP	ESTHER
CHRISTTN	CHRISTIN
WROUSSEAU	ROUSSEAU
PIISJIOHDLEIIHAINMLIM	JADE
SHAWIET	SAUZET
AMWLLNEWXORIIW	ALIENOR
MSBSLLFE	BILLIE
MPSTBVILLLULAVRYOYLLV	BILLARD
NWWACMHWELOW	RACHEL
MMSMWMIVDCTDWTOIDIHUN	BOENTAIN
REY	REY
SLHIAALAH	SARAH
MWENAAVTWLLJ	MENAA
LLWSRYIANL	RYAN
MEBE	MEGE
WATHE	AGATHE
PPENET	PENET
NIIV	REDIS
AQTHUK	ARTHUR
WMSYDRULDYRLAVTLIJLSCLHVHITT	DUPRAT SCHMITT
WKMRZVYLZLPOWVADXWNLL	KAZYZONIAK
LJWSLSELXVFVOVULLIL	SEKIOU
TLSLIAUHHHALI	LAKHAL
YFERWI	YERBE
JSLTLSIAILBELTII	TSABET
PSHAXENCF	MAXENCE
DMSVLVLLOLNL	VIVON
JEANNE	JEANNE
DEUX	DEUX
HAHAUT	MAHAUT
JULIEX	JULIEN
WABSSMAWNW	ASSA
CHABAUDWE	CHABAUD ALIE
PSSTEUE	STEVE
NMXWNUUWIW	NOAH
LNLI	ELISE
HLFSLOCHE	FILOCHE
WLWEOMNWIEW	LEONIE
CCARA	CLARA
SWOUBOUDOUTLVLVLLL	SOUBOUDOU
PSALEXIS	ALEXIS
PENET	RENET
PAWLC	ANNIC
WNAPD	MINARD
MSWRGAUII	HORGAUE
EVA	EVA
DPFLANOUE	DELANOUE
KLEIN	KLEIN
WSHITHZEU	MATHIEU
WHBEU	MATHEO
VIDXNEY	VIANNEY
CERFU	GERIN
ALEXAWWE	ALEXANDRE
LORZDAN	LORIDAN
MLEW	LESCA
MESSLNA	MESSINA
BMILAL	BILAL
MWICHEL	MICHEL
ALSTACY	STACY
PHLLLPPE	PHILIPPE
MAWE	MARIE
CYABOILDOUBLET	CABO BOUBLET
BOURAER	BOURRET
VMSLOMBDRDLOL	LOMBARDO
IWIHLIIOWTHIIW	ELIOTT
CLFHLNIE	CLEMENCE
AUUUSTLN	AUGUSTIN
PIIARGAUX	MARGAUX
LJCNUY	LENNY
LWEMKVLLLARL	LEMAIRE
MLHCOSTE	LA COSTE
WLABEL	ABEL
DAUW	BAUER
BOWOUR	BONJOUR
TMULFS	JULES
WMLPMRIVFAYUJNUYIOBU	PREAUD
VAZ	VAZ
MLWOLNSWHW	LOIS
LPLCLAQA	CLARA
FPAVWIBULSSON	FAVRE BUISSON
EVOENILE	EUGENE
PIBFLNJLAIMLLNIALHLI	BENJAMIN
GUCUCRBULAN	GUEVORGVIAN
MAYHAM	MAYNARD
WMIQENJWNW	INES
ELCVOLZ	EICHOLZ
MYSFNCALSVDVALIRDLLVV	CASDARD
LAW	LANA
WMMWWWDM	DVEPJE
BBLLOT	BALLOT
WLMANTINE	MARTINE
NLLOLAS	NICOLAS
VLCTOR	VICTOR
OWSRADILCAULT	RAPICAULT
LANA	LANA
SWSPALLLLALNCFLII	PALLANCA
BEWOTT	BENOTT
WMMYLLYTVVNML	PRADET
UCTORIA	VICTORIA
DEPONCINS	DEPONCINS
MANCCAUX	ANCEAUX
HLNET	MINET
ARTHUK	ARTHUR
ALLENOR	ALIENOR
MYSFLLLUVEJIVVVLV	LAZE
WWNPSMEWXEW	ARSENE
OPECNEMARNIN	DECHEMARDIN
WSANAJS	ANAIS
FLORINE	FLORINE
PARSY	PARSY
WSHDQIOH	MARION
WLTAHGUY	TANGUY
YAKHLIFI	YAKHLIFI
IJLULLIIANIH	JULIAN
IWSLVOCENLTL	NOCENT
WLEM	MYLENE
RHAILY	RMAILY
JULLETTF	JULIETTE
LPJSIAIWEI	SIRINE
PIAINAELLE	ANAELLE
PIWSTLLEN	BASTIEN
ABHFLMALEK	ABDELMALEK
DIW	SAIDI
WWVICNTWORIANM	VICTORIA
TSLHIUHJI	LIU
WSCLEO	CLEO
MLPADJENI	PADJEN
LFFFAWHEVR	LE FAUCHEUR
LEGAL	LE GAL
PMICAPRNVVLYYL	RICARD
WAYOLLE	WAYOLLE
KPA	LEA
PLSAKFSSYLLLL	ARESSY
IWLHWUAWSHLLL	LUKAS
HTTLAS	ATTIAS
TMWIAMNWANW	TIANA
AOANDJN	JOHNSON
YBLLCNTLN	VALENTIN
VAWGW	VALENTIN
LLNWILEROLUXLLF	LEROUX
LORWJHF	CORRAINE
CLLIVC	OLIVO
MAIHILDF	MATHILDE
KY	KY
JSCTOR	VICTOR
CHFILUNL	GHEZELANE
MWKLLYVLVVL	VIGEL
HLBELCKL	BECK
MPIQUEHAL	PIQUEMAL
EHHA	EMMA
SADIC	BADIO
LLLINFA	LINA
MATHLFU	MATHIEU
MARTELFN	MARTELIN
LPIISIRNEMLIININNNWNW	REMI
FWAUVEJ	FAUVEL
LANOELYS	VANGELYS
LSMIOPLWLEILLLL	SOPHIE
MSLBERNLAOLLL	BERNAD
QRIOUH	QARIOUH
WMLTCMULUESLNUCTNDUV	GUESDON
FMLEOLNIVVLJVL	GOEGAN
DERDUADD	DEROMARD
NWHTHAN	NATHAN
HIATHLILW	MATHILDE
JULIIETTE	JULIETTE
WIWORLA	GLORIA
MMSRCMAIUNJEYJNANNEV	CANESSANE
SCJOLLA	SCIOLLA
TRXMHEL	TRAMHEL
WWNWNESLLVL	DESBONNES
PSLHINER	CHIPIER
ILLILLLAHINLLL	ANTOINE
WWLREHOUTYYVIJLY	MPREMONT
FFLIX	FELIX
MMNAW	MAMAW
SADELHI	SADELLI
LCIA	LEA
UERTHALAY	BERTHALAY
GALLSEVVE	GALLIENNE
SIVASAKTHI	SIVASAKTHI
CWLLHLELLHLLAYLVLLIVLL	CHEMLA
LPITHCNW	THOMAS
HATLTS	MATHIS
MMWMLHAWLLL	AMAYA
WSSLXTLNE	SIXTINE
MMSRMNLIIULNRJLDUVSDYN	NICOLAS
TLEDDY	TEDDY
RWWWNLUNWILW	ROBIN
BRDDOUX	GRADOUX
ALIM	ALINE
RLOLHALFF	LOTHAIRE
HANELH	MANECH
LPLFLEIRLCLHAL	FERCHAL
MSJULIFN	JULIEN
MLLCAYMVWJLIN	CAPUTO
WLWIJLLLLL	HEIDI
LALLAURET	LALLAAURET
ALCAYA	ACAYA
WLEYS	INES
IRWHOBNLWAHIH	ROBIN
LASSALKE	LASSALLE
HHKRAE	MARIE
SAMML	SAMUEL
UWJRASCALLLROULL	RASCALOU
HLSLYILNAULT	BOISGERAULT
PLDAZIW	DAZIN
MMSRJMALVVLAVZNZOJLIV	JAVAZZO
BEYLER	BEYLER
CHARPENTLFR	CHARPENTIER
CHANTERANNE	CHANTERANNE
JTLOWA	ILONA
AWWMBNRBEIIH	AMBRE
PTEIIAPIV	PELLARIN
IMSLEMABNENL	LEMAGNEN
CHARLONE	CHARLOTTE
JRULINET	RUINET
WSTLNE	JUSTINE
HJFUSLILLIER	FUSILLIER
LSWIULLLEFLLHLH	JULIE
NMLLETLELRLALLLELLL	LETERRIER
DUBOS	DUBOS
NWSIILICLFZ	TISSIER
IMSHAOLLHF	HABCHI
PLRIONALIINLILIH	ROMAIN
BYEGEL	BEGEL
CONUEMLNE	CONDEMINE
GWLASERVIIVVYNL	GLASER
THIIGAULT	THIBAULT
HORILAH	MORIAH
YSFADILAN	FABIAN
TPHASNE	TYPHAINE
MYER	MEYER
MAAIE	MARIE
YANN	YANN
LUNEAU	LUNEAU
PSDFLILIIISLF	DELISLE
AUPELLFN	AURELIEN
LAHONDESDELNF	LAHONDES
YMWJWNCWHTIW	VINCENT
WEVINS	DJEVINS
MMSMMFFIVNYNALJJVV	FENET
QWBUENMWNMJL	QUENTIN
MKYHAMDWIMNW	KHADIJA
LLASDUPUIS	DUPUIS
VPLAL	VIAL
EHRLIQUE	ENRIQUE
TYHLBALLT	THIBAULT
MDBARDIILVALRLBLYAVSL	JOBARD VARGAS
MMWYNSWSWNENW	MEYSSOUNE
NWOEME	NOEMIE
ASSRUS	ASSOUS
LUWSMEINLNILEVCHFT	MENNECHET
LLPWA	LUNA
FGULRELONTEK	FAURE CONTER
ALLCE	ALICE
PEPIN	PEPIN
PSIORAXLJZHLAEL	LORANDEMAEL
WMMFMLVMEZTUNITUYR	POILVERT
IABNMFNRWAHILU	AMIRA
WLEMMA	EMMA
MLLLSFDLLALVUTLWSLVRULJJ	DAVIS
LBIGREGAM	LE GREGAM
WDURVLLLELLIILLLL	DURVILLE
WSCHONTICUD	CHONTICHA
HWSLBRLOMLELTFLLL	BROMET
LEGENON	LEGENORE
CSRENTLIN	CORENTIN
MSBAKOURF	BAKOURI
CULOE	CHLOE
MYSTRFIYVVELNVETLLILA	RIVENET
MMLRBVOLYVCLFILLYIN	BOYER
WWLLH	WILLM
LWSTHDMAS	THOMAS
LENOTTE	LENOTTE
ELEIYA	ELISA
NINA	NINA
HWWARMWWIMW	HARINE
HUELIRENENW	HELENE
WSFDWVN	SANQUER
WWLLLLLLLL	COHEN
GLRFAU	GIREAU
LAUOVA	LAHOUQ
AZWAGUI	AZNAGUI
LLUU	LILOU
VFLCFAT	VALLART
DERFMY	JEREMY
PSADLBUX	ANKHUR
LPSRMHLLW	MATHILDE
TMWOMNWWILW	TOM
LEFAUCHWR	LE FAUCHEUR
NATHILLDE	MATHILDE
NOWTAWE	MONTAGNE
BCHJAMN	BENSAMIN
MWLIAMMWNM	LIAME
OMSBOUSSARD	BOUSSARD
WLLOTFI	LOTFI
RONAIN	ROMAIN
MSLEA	LEA
LEYRAT	LEYRAT
GUILBAUD	GUILBAUD
PILILOU	LILOU
GWRAVDATZILLLLL	GRANDAZZI
AZTHUR	ARTHUR
ALLCE	ALICE
PIFNNAIFSLI	ANAIS
JFNIFEQ	JENIFER
HATHIILDE	MATHILDE
ALWLXEJLHHLL	AXEL
AWWXLNNWENW	AMINE
WSCECILIA	CECILIA
WSUWG	PENG
WBOURIIEL	BOURIEL
EHHH	EMMA
ALLICIA	ALICIA
UARIE	MARIE
IHES	INES
CROVTFLLE	CROUTELLE
WMSMWMIWMYUYDM	DAUTEL
UWNCYLOC	MARYLOU
WSTUEROFNLY	THERON
ELBTYELLE	ESTELLE
LYLMULIERJ	MULIER
WLLLIVA	LINA
VYFDZEUNOS	VIDZIUNAG
BOUTENEORE	BOUTENEGRE
LWARZANLLL	LARZABAL
DWEYAYLVLLLIL	DEMAY
NWMLLWAWHW	JULIA
PSELISE	ELISE
MATTHIEU	MATTHIEU
HIOOHES	GOMES
CWWUEHACLA	GUENANCIH
DMSROULLHNLLILLLLL	MOUHAIG
SWOUFFLIPYYILVLL	SOUFFIR
INSRID	INGRID
ALEXNDFE	ALEXANDRE
GWUQLLEMAGLNLLLLLL	GUILLEMAIN
OESURY	DE SURY
WIANTCNY	ANTONY
KYLIE	KYLIE
WBLAWHEJ	BLANCHET
LMSLYFLELELNALNLDLFLLSL	FEBNANDES
NVI	THEO
BQAUN	BRAUN
WMSYRHALRUIVOZAULUOILSOL	MARCIALIS
IWLBOURRLLAT	BOURRAT
HFRVIEU	HERVIEU
PJALEXLS	ALEXIS
BMARBOA	BARBOJA
GIRISH	GIRISH
EWURAFYQULLLLLV	ERRAFYQY
PIISMLALNIOINHAHMM	MANON
CWHORMHWLIEW	CORALIE
MILDFLLCYTHVLL	DELOT
ERLIHF	ERINE
SEWSFLIEN	SEBASTIEN
MMSRLVALBVAVDIULLIIRI	LABADZE
JFNIJFW	JENIFER
LOPES	LOPES
UUURC	COUDERC
ATBFRN	ABERTH
SENJAMLN	BENJAMIN
NACL	NAEL
DALLLA	DALILA
VOLFF	VOLFF
THOMAS	THOMAS
MONTANE	MONTANE
MSVENEREAUP	VENEREAU
DESFOSSES	DESFOSSES
ELWEI	ELLENE
BMHOMME	BONHOMME
MHWAXNWWNM	MANON
LUWLWCLLLOLILULLLL	BACIOIU
MIGUEGRNILLIEUTLEX	GUEGAN-LIEUTIER
WSFAYFAL	FAYSAL
THOMAS	THOMAS
ASHWSNI	HOUSNI
ISLDN	ISLAM
LUUS	LUCAS
THEO	THEO
HLAALLEILW	MARIE
UWSTPG	LUSTIG
SLOH	SION
MSLAURE	LAURE
TRLSTAN	TRISTAN
MATTHIAS	MATTHIAS
MMLMNMAIUATNFVXVVOUL	RARDEX
BYOUZIDI	BOUZIDI
KUJAWA	KUTAWA
GAANIER	GARNIER
ZMEBORNELLLLLL	LEBORNE
LLPSJIOIIUBLCKJNI	JOUBERT
DWUVALLVLLLLL	DUVAL
MLYSYRMELVVEVJRVSYATVLTNIOREL	REVERSAT - MOREL
CHFHLYTF	CHARLOTTE
LMYSFDVILVHEJAIBHOUWVEVZV	D'HERBOMEZ
CBORIAILLEIIU	CORALIE
ULNRPLH	KARIM
MILA	MILA
WSENZO	ENZO
WSMATHEC	MATHEO
WWIWLWQSDLUBAGZLGZPY	GOUYOU
CARPY	CARPY
MMSMTMHIULICLJLOUNJTTR	THIOION
LRNW	LINDA
LFFOY	LEROY
IMILDENVVISYVLVL	DENIS
NWLULUWIW	LEO
SENLIH	SEMIN
SASGNAT	SAIGNAT
THEO	THEO
MLLSLHOVYSRAIWDLIVL	MOYSAN
NHHAN	NATHAN
PSJULLVCS	JULES
ARSONC	ARIANE
HATHIS	MATHIS
FZRREZRA	FERREIRA
PMFNNDIEVRUALIYIL	PENNETIER
NWAS	THOMAS
AMSESTVELBLALWYLLL	ESTEBAN
CWAILLETLL	CAILLET
EHLLIE	EMILIE
LOUET	LOVET
CWWLENMWENTIW	CLEMENT
AHELLE	AMELINE
UW	CLOE
JVLINF	JULINE
MXWAINAUWHIM	WAFA
IMSLAULKELNJLTYVV	LAURENT
JFREMLE	JEREMIE
LWOMY	LENDORMY
PSEMA	EMA
PLAYADAIT	AYADAY
MDXAXNLWWNW	MAXIME
WHA	EMMA
FDAN	ADAM
EPRLNN	ERINN
PISULLQVAN	SULLIVAN
TWJRBELLLELSVLLL	TORREILLES
PWORTOERLLLLLLLL	PORTEPR
LPSYAXDECBSTEEZEQ	VAN DE CASTEELE
NAGNARD	MAGNARD
SYQIELLE	SYRIELLE
BWBA	BOMBA
POFWSFGWOW	POINSIGNON
WWDNN	EVANN
PETEP	PESTEP
LEROY	LEROY
LIWSSOYULLELLLLLYFBLOW	SOULEILLEBOUT
SALCDE	SALOME
PILSIMNUNJIAJPAHIAIIWIW	MUSTAPHA
PSTHONAS	THOMAS
LMMCHEL	RACHEL
AMLBLRLOLSE	AMBROISE
WSRAPTISTEL	BAPTISTE
CMAZDDOXNE	CAZABONNE
GWBAWMWIELNW	GABRIEL
WRLIN	MORIN
MLACFVE	LACAVE
PONMLER	POMMIER
JAVOURNFN	SAVOURNIN
PSCIAINUWHJ	CANDICE
FWLPAIAN	FLORIAN
MNBINHOWNHW	NINON
MMSMMLLIVAHTVIOJLTN	BLANO
DELLLLF	DELILLE
LMMEE	NOEE
LUYLAS	LUCAS
MLLLLTSRWYOUKIYWV	SAUOYE
NZHAN	NATHAN
HARZOH	MARION
SOUCIANE	SOUFIANE
COREWTIN	CORENTIN
LYAFOSSE	LAFOSSE
LUFIEDIIFN	VALERIAN
WALN	WAIN
CWLFHALRLRIYEQEVILLLIIV	CHARRRIERE
SLLTCLJ	BUNTOIS
DEVAUX	DEVAUX
BPLERRF	PIERRE
LEONARD	LEONARD
TANGUY	TANGUY
LAUREW	LAURENT
WPASCALVVVYYYVL	PASCAL
SLLVAYLFONTEJ	SILVA SIFONTES
PSSEBASTEEN	SEBASTIEN
MJBRYWLSJSYELVJLL	BROUSSE
WSKYLIW	KYLIAN
KWWLS	ROELS
JWSCAHLELVLTNL	CAHELIN
LWWNANMS	LOU-ANAIS
MILHAGULVELULRL	MAGUEUR
WJANNA	ANNA
CWWOLMLWNMW	COLIN
ALVESDASILVA	ALVES DASILVA
AMWNANIWSNW	ANAIS
LLMSALALOLUF	ALALOUF
DMLLALLLLLETLYNVUJIL	DALLET
LEWLUA	ELENA
LEBIDHW	LE BIHAN
SILMON	SIMON
RUBEET	ROBERT
PSFLWENN	ELWENN
MSYWLFVRRUEVILLJVLVJ	BORREIL
VERHOTIDESPOCHES	VERMOT-DESROCHES
LWSHAFLYNE	MARLYNE
LLPSALBERTI	ALBERT
MMSTNKULGLELNLLCLRLLTL	KUGENER
BELLFERE	BELLIERE
ALEXANDRE	ALEXANDRE
TLMOTUE	TIMOTHE
NANON	MANON
BWHAU	BRETEAU
LFEVEN	LEVEN
MMSTRABLDVJELSUVLLL	ABBES
MLEQLON	LEBLON
IVEC	THEO
MMSYVROLUVXVIYVLLV	ROUX
RAJENDRAM	RAJENDRAM
MJARTHUR	ARTHUR
WWLMWUFSDVULLIOLLBLISLH	HERHFOUR
GIRAUD	GIRAUD
MLHSLADJ	LASLADJ
JMWVLNIWLMHW	JULIEN
MUHSIWE	MOUHSINE
LWALELVVDNYLL	CAREL
WWSMMGAIUPEOYLJYYYZ	GAREL
PLSJFJSIMIWIW	JESSIM
PSSINON	SIMON
LWENIWVLYVYVL	LEMIRE
IEWRJLLLL	MARQUET
DWSTHONASSET	THOMASSET
HIWNARNGOWTHILW	MARGOT
WSSCFIANE	SOFIANE
PLLAPHAULLINAHLNWIU	PAUL
WFDIA	NADIA
CHCLLET	CHOLLET
WMLWMMNLHUTOJUODIOZTAW	MONTURET
CREUEL	CREVEL
WSWTHIEU	MATHIEU
NAVEOSDERTHOU	NAVEOS-BERTHOU
LCLMLEHENT	CLEMENT
LNWINOUJAHFP	MOUJAMED
WWWFCI	CEDRIC
WSLOLA	LOLA
WMSMMDJILFDLLLOHLUYJJL	DJELLA
VMSFOILIUIFUNIUFLL	BOISBUNON
WSNELHARFEIL	DEHARRE
ZOE	ZOE
MSYHNLS	YANIS
JRRMA	TERRARA
WMLWLIPAGEOT	DIEGO-PAGEOT
LWSLOPELZILVYL	LOPEZ
THLBAUD	THIBAUD
CADEL	CADEL
ESTELLE	ESTELLE
LOUIANNE	LOU - ANNE
JLEREHY	JEREMY
NOELLE	NOELIE
WSAHEL	AMEL
PJLVLLVED	MOHAMED
LMWUCNIWLENW	LUCILE
WMLMLWLILUNJJLULWIU	LAZOU
TAN	IAN
ETRLL	ETHAN
WLALLSNELLLLVLL	LAVIGNE
CORDUAN	CORDUAN
AWLTHFYLLLLILELLRLL	THELLIER
WSMELLNAL	MELINA
PSANNAELLE	ANNAELLE
JWBAUNWWRAWIW	JAUCERANNE
ARNOLD	ARNOLD
PSLOCIS	LOUIS
CONBENALE	COMBEMALE
CLEMEWTIXE	CLEMENTINE
CWWLANRWAIM	CLARA
EYAW	EVAN
IMSLEKLOLIRRES	LESGOIRRES
MSPREVLOLT	PREVOT
HMBNWWFSLWNW	STANISLAS
MSCYPRIENL	CYPRIEN
AUXELLEN	AURELIEN
WLLLELNE	SOLENE
LOLA	LOLA
HWWUSNEWYINNM	HUSEYIN
IAWLLE	CAMILLE
RMSBFRLILLLLLIRLL	BERTHIER
BYISUIY	BIQUET
MWCMMPOIVDVRZNYICVYKVCL	PODRZYCKI
LWESAGELLVLULL	LESAGE
MYBANNIWSNM	YANIS
WLSEN	BASTIEN
HARGOT	MARGOT
PSAUGUSTLW	AUGUSTIN
XREWY	ERENEY
HKLAIIRGNW	KLARA
IEANILOUP	JEAN-LOUP
MWSMJMEIGUJOOUUWLC	JEGO
WRLFRPELDLRLVOTLIIJL	PEDROT
CHAWWWE	CHADOURNE
BMELLON	BELLON
IWLLSTDLUVVVALVLVLLL	DUVAL
ELHAMWOUT	ELHAMDAOUI
CLFHEHCF	CLEMENCE
MLEZOUGHZHORAN	MEZOUGH MORAN
MLPERRET	PERRET
FLWIKELSLCLIILLINLH	PRESCILLIA
IDLLELBOLT	DIEBOLT
DEFPEKLN	DEFRETIN
BEUREL	BEUREL
THLZAULT	THIPAULT
BURAK	BURAK
YLJZANIBAPIIISTE	JEAN-BAPTISTE
MMWANNOWNIW	MANON
LPSMELONJL	MELONI
GMCUAUW	ROUAUL
RLFWRRE	LE CORRE
PSALEXIS	ALEXIS
LNWSLAUUNT	LAURENT
HAELYS	MAELYS
CLJLIONE	GUIGNE
PSTHEOWRA	THEODORA
ANGELE	ANGELE
LAWLIYAH	ALIYAH
WSLILNC	LUCAS
ETVREAUX	LEVREAUX
NATHLFU	MATHIEU
LUOIVINE	LUDIVINE
AMLALNLDIM	AMANDINE
PAULLN	PAULIN
WIANTOQUFI	ANTOINE
LLPSALIICLCALLLWLW	ALICE
LFHUEDE	LEHUEDE
LWSZOE	ZOE
JIWHSJEJHIJMIH	JOSEPHINE
LWOLA	LOLA
PSARTHLRL	ARTHUR
WWSMWLDNUXPULUCJUC	LAVIAIF
DOVEDA	DOVEDA
DIIISVILHLIEINNTMLNNWIIP	VALENTIN
PLVICENT	VICENT
MLWILLFLL	AMEL
WTSSM	WISSAN
WOEME	NOEMIC
RUAWLT	RUANLT
HETLERI	METIER
CHLUE	CHLOE
MSLLEDUC	LEDUC
WOUET	DROUET
IWSDEKLENSL	DEKENS
WLENTE	DELENTE
WW	BEN
FPANCHETEAU	FRANCHETEAU
PLEFMH	EIMAN
LWLLRNLCLLYLVILIF	RNELY
USNARLCHY	MARICHY
NWSZEROULALII	ZEROUALI
LANDRIFRF	LANDRIERE
WLLUCIF	LUCIE
WPLOMEISYCVJHAHHPUYSULL	DESCHAMPS
WLAYAL	DELAYAL
HWUILIN	SECRETIN
UURESAH	MEDRISAH
MATHZ	MATHEO
RAUX	RAUX
KENOUF	RENOUF
MLLYOVULISLLLVI	NOVIS
WNWANMOWNRW	MANON
LMSRREU	THEO
LY	LY
WPLMFZISULJLOCNNJX	FISLI
SUBTIL	SUBTIL
DIAB	DIAB
IUWHEGIVWEHIH	MERUE
PLERGN	ERIN
BLNHNL	GIANNI
MMSYQMHICVHYTALADBSDN	RICHARD
JADE	JADE
MARWN	MARWAN
NLWATHW	NATHAN
LEGALL	LE GALL
PCDIHEROUVILLF	D' HEROUVILLE
AWQRAYE	AQRAYE
WSDONATIU	DONATIEN
RLIALLQND	RIALLAND
CASTEL	CASTEL
ALYSSA	ALYSSIA
MLLMA	LIMA
NOENIE	NOEMIE
GIRAULT	GIRAULT
MMWWNWWHM	MANON
LLLUPCAS	LUCAS
LWEHENOLILLILLL	LEHENO
JHIHA	JHIMA
WEZ	DUEZ
PLILJIIULLLLIEWNANWLNM	JULIEN
AWGATHE	AGATHE
HHXIME	MAXIME
MMSVVALLAVTUXVYYLLJ	ALAUX
WWIMTMASOLIZZILOOZZXLL	TOSON
PLSBLELRTJAUILXIIIWIW	BERTAUX
ELEN	ELEA
DZLKICLOLL	DZIECIOL
WHZLSVLVJYULL	AZZIS
NPZNA	NINA
PAUL	PAUL
LPIILDTONNHUOARONMIIM	TOM
CLEANDAF	LEANDRE
LWISA	LISA
DEMLJPJ	DE MORET
LWSALOWB	ALONG
NELLNA	NELINA
NEPVEVX	NEPVEUX
WWNIIMOWLASW	NICOLAS
STFLHARSKI	STELMARSKI
CLELIA	CLFLIA
TCUTDSINE	TOUIDSINE
TWEWNTAPVLVLVLLA	TENENTAP
LWEYGLENEULLLLLL	LEYGLENE
FSTFWN	ESTEBAN
MMIRWMLVEDU	SOTICIK
TWLLLOLKLLLLVUJLUVNR	THOREL
GWNAELLE	GWENAELLE
LDSHAWW	MARTIN
LORBNU	LORENZO
WWAA	BOUDRAA
MSTALILA	TALIA
ALHBU	AMBRE
BENABOEFRAHMAM	BEN ABOERRAHMANE
CAUSSADF	CAUSSADE
HWWFLNAWPLEHW	MELANIE
WIWEN	EHDEN
FDEN	EDEN
CWWIHNIIWLLENW	CAMILLE
CLAAA	CLARA
JLAOE	JADE
BALEY	BALEY
MMSMCMHIVOCRQJONBYSD	CHARRON
ELOJSE	ELOISE
LEBPFS	LE BRIS
MSLBEWLLZZLTEVLL	BENIZE
ROMNE	ROMANE
LWWIHMWW	LISA
PSHATTHIAS	MATTHIAS
WSPFERRE	PIERRE
WCVILTOR	VICTOR
KMLLLIAN	KILLIAN
SORIN	SORIN
YSFLCLULLLLLERLAT	FOUILLERAT
OMBCEMAWWENW	OCEANNE
WWMULENZMEZUDJAYN	BOURIEZ
NOEL	NOEL
SHLAYNGE	SHANGE
HMSJEANLNELL	JEANNE
IWMLRVPOLVLJWQUVJJLL	VOLKAERT
NALTLHLILDE	MATHILDE
NWLLBGYHIBLBLJZVWLLY	BWQED
LUMWNVM	FEDOROVNA
PSONDINE	ONDINE
LILLY	LILY
ROBILN	ROBIN
PSMLCLHEL	MICHEL
IWXRAH	IKRAH
TLWCWY	TONY
JSDIOR	DIOR
PSHUGO	HUGO
MILEANDRO	LEANDRO
LLWPSMPZLQULOELHIABJLVY	PIQUEMAL
MORGAN	MORGAN
PSHAWL	NAWEL
YGRAEFFLY	GRAEFFLY
TARPOVX	TARROUX
GESJRE	GREGOIRE
LWEA	LEA
BEDLELL	BEDELL
JOUCHIM	JOACHIM
BSGALLALNIT	GALLANT
NWAD	NATHAN
JLWIFRJEDJYLLH	JERIAL
VWIDACCON	BACCON
GUEWN	GUEGUEN
AHMFD	AHMED
MMSPPMFILDALNLOLUVLLLL	PEDANOU
MWWMWNM	REMY
OWLIVZFA	OLIVIER
WSWLIW	MELINE
JEHNNE	JEANNE
WSEHLIRHAN	EMIRHAN
ARAGNOU	ARAGNOU
FMLOUIWONELSVVL	QUINONES
FEDWANN	REDWANN
MBOUVART	BOVVART
MMJTLHLALHVLLLLLLVY	MAMI
NWGUY	TANGUY
HARLE	MARIE
DARLBI	DARIBI
PPAULJNE	PAULINE
YASMILNCR	YASMINE
WLWZMMWMMW	IZOENN
NQMULEL	NATHAWIEL
WLWWMAWNW	LOLA
PELLETIER	PELLETIER
DELAHAYE	DELAHAYE
LWLGWLWON	GOUGEON
AMTTIPS	ATTIAS
PLCMO	PICAZO
HWWOAMOWCEMW	HORACE
PIFRROT	PIERROT
CRLSSN	CRISSOT
KERBOURCLHU	KERBOURCH
IIHHCO	NATHLO
AMSASULELRLLL	ASTIER
BMSTAUVERON	TRUVERON
NWSKERLSLUIALLYLLLL	KERSUAL
WSAUXFNCF	AUXENCE
BADLISTF	BAPTISTE
FILLLBI	DENUIZHE
DQTHPLW	MATHILDE
BEYZA	BEYZA
LWTLNRLRLRNLSYLLULL	TORRES
NLWIELJIHNAHLL	HELINA
WEWSNLIIHLLEIH	ESTELLE
PSBERENICE	BERENICE
WLANAELLF	ANAELLE
GUIGUET	GUIGUET
TWOURNEBLSEL	TOURNERISE
RONAIN	ROMAIN
IWSILIIIJVRLHLVL	REGAL
LMLVSPVWLUUYJSJSJEJTIDU	MOUSSET
WWELLLNOWTNW	ELIOT
XPNS	JORIS
WLUBLN	LUBIN
XIMA	XIMA
IWES	INES
LLEFJOSNE	LEJOSNE
NLCLIPHORF	NICEPHORE
WWAWMWRM	AURORE
VANDELDHR	VAN DE LAAR
JANES	JAMES
BARAGHOU	BARAGNON
AUYRORE	AURORE
WWRWVVLILL	LEMPREUX
NWELLLLLL	NE
LALFE	LALIE
WSLULASL	LUCAS
MWYAENLWNW	GAEL
PSALZENOR	ALIENOR
UMLLELLHIEHLI	ZDELIE
MLCLKHENT	CLEMENT
IWLRISPELL	RISPE
JALUB	JACOB
GERWNDE	GERSENDE
FWMSTFRALLULDLFYYLID	FAURE
WSKWV	THEO
CWLLINENT	CLEAENT
LWW	JORDAN
CHENEVLER	CHENEVIER
WMU	SARI
WW	NOAM
NW	NOA
LMECORRE	LE CORRE
LWSLULLA	LUIZA
ANDREA	ANDREA
CMETIEW	CHRETIEN
FLERNANDES	FERNANDES
MMLTINULFVVAVLLVILOJLVINLE	INFALLIBILE
NLICCLAJ	NICOLAS
MLWLAXLELFNLCLE	MAXENCE
WWWWIWTILLEIW	DOMITILLE
NLTFAKU	NTAKU
PLEREEDOV	PIERREDON
RABLLLARD	RABILLARD
DEWIXIVF	DEGRAEVE
NDTHEO	MATHEO
PSCASTIGLLILAI	CASTIGLIA
PSVLOLLLALNIV	VIOLAINE
DEIVAHBAL	DEIVAMBAL
MYBEIHIWSZFHW	MELISSA
PSMATTHLEV	MATTHIEV
LMMSPDMELVLVCOVVUIRDTVJL	DELCOURT
TRAAAND	TRARAND
MWZLPLLJLIL	SFEZ
PSCELLNE	CELINE
MMSTDRELVNPAJYVELCLHLNF	BEN AYECHE
LLIFMELT	CLIMENT
WROUIAELTEL	ROUCHETTE
WLELAN	OCEAN
PSIWE	INES
LLWLTACHELLLVLI	TACHE
MSSOLFW	SOLENN
MMSRTMDLYUJNVVINVSLU	MAERTEMS
UUZRRIIN	QUENTIN
LWEIVAJFIFILH	EVA
RUHLER	REGNIER
HELLXHADIR	EL KHADIR
WMWLHUWPYHM	MALLORY
PSHIPPOLYTE	HIPPOLYTE
SHUL	SIHAM
AMSNFRDLL	OSNGRO
SWAN	SWAN
BENBAAOUK	BENBAROUK
PLLLLEAIII	LEA
WDBRAFYLLILL	DARAFY
KWAMKWLLLNLEL	KAME KENMOGNE
WSANTONSNL	ANTONIN
LLRULLIIIILF	LUCILLE
ZLHHER	ZIMMER
FAVFAIS	FAVERIS
CLPENENT	CLEMENT
PILCUPFEIRAANERHHNMILW	PIERRE
LLLJAI	LEA
NWWANNOWNNM	MANON
WLPTJRFFCOBJCHZI	BOLPAIRE ECOBICHJ
LANCELOT	LANCELOT
FCNTE	FONTE
SWSSANLLIIIULLL	SANIEZ
HUGO	HUGO
GMQT	BENOIT
NWWHRMLWNEOW	MARINE
BIAIWLWLICLZ	RIBOWICZ
LWSLOGANE	LOGANE
FLAHAUT	FLAHAUT
TLANYBUYI	TANGUY
PLPAUL	PAUL
WJDALEA	DALIA
ADELPHE	ADELPHE
LPSHAXIRE	MAXINE
LMMLRMUOIVVPLLIVLIOJL	GOUPIL
CHEKLNE	CHERINE
FAVCHFREIICOLLLN	FAUCHERE-COLLIN
MELISSA	MELISSA
GAWTET	GANTET
KILLIAN	KILLIAN
ACHY	ACHY
ANLLYTA	ANITA
WLEFLAGUUAYLSYLLLVY	LE FLAGUAIS
PIFLIWLIAI	SONIA
MBRVN	BRUN
VLICFTOINE	VICTOIRE
MLLRUTLLELRVVLLL	RUTER
DGUDRAD	ENGUERRAN
WSLEGLEWDPE	LEGENDRE
JWWOEMYWHW	JOEY
ARNAVD	ARNAUD
GUCVAXU	GURVAND
NWSZEBRUDL	LE BRUD
AMFWLL	NADAL
LJMLHAMRARASL	HAMRARAS
WIAGATHE	AGATHE
MUNCH	MUNCH
MWUENSWNM	INES
JMWULNFWENNM	JULIEN
NATHAN	NATHAN
MESSAGER	MESSAGER
WMSMCMUIUWLCVULPUL	CUREAU
ELICE	ELISE
LWALLLEHAND	LALLEMAND
OFFANCE	GARANCE
IJWHULNIBETTEIH	JULIETTE
PJILGILL	LOIC
PSTHOHGSIWI	THOMAS
ALFENOR	ALIENDR
MALORLE	MALORIE
DWSLAFIONT	LAFONT
DTUBIEUX	DURIEUX
MMSTAMLIVOIISIILYVL	ALOIS
LWMSYHMOISVIPIILTLALJLI	HOSPITAL
RWWOQZRLLIL	RYCGAZ
WLVRLLOLUFLFLELTLLLL	ROUFFET
PCALENITLLNL	QUENTIN
NWILAVZOILUOLULLULEL	LABOUDIGUE
WMLMMOLIIUNYLRDIYBPTLOM	AUNIBERT
LMMSRVMEIVRGVUIEHJIRIZAL	VERGUEIRA
IDLBIIUJLILLLLL	LUIS
EMAN	ETHAN
LBSBERNIER	BERNIER
IMSHFRLBLELTLHLLLI	HERBETH
MAYLME	MAXIME
MWTHOMMWAJW	THOMAS
WSDOWILHLL	ROMAIN
RYEVET	REVET
WSAGATHE	AGATHE
THKTLLINEZ	MARTINEZ
ADDRM	ANDREA
WMSIIFRIDINUJ	FRIOU
CIWBHLLOLELFILLL	CHLOE
LIICFI	COSP
PSJXANHEILYJ	JEANNE-LYS
CHDRLIIE	CHARLIE
LOULIS	LOUIS
MLLLLSTSLLVOLVUFLSJNVVCYJL	DUQUESNOY
EWULALIE	EULALIE
WLLSSI	ROSSI
WLLIFLCLAIVLLLVAVLYDLI	CAILLAUD
ASRALCLOIT	RACLOT
ILLLILLFYI	LUCAS
ARRIBAS	ARRIBAS
PIISLDALLIYLAIHHLNWIW	DALYA
VWERXKRKE	VERKERKE
HEISD	MEISSA
OWUMAR	OUMAR
LLWLYLFHLLARLTVYLVYVVL	HARTIN
WWKENNZWAAM	KENZA
MMLRRROLYYVJULJLL	ROY
XAZEHELA	NAZEKELA
RMOYEALLLFILAV	ROYER
LOUANE	LOUANE
BLSABELLE	ISABELLE
AVRELLI	PAURELLE
GERAUD	GERAUD
GMWWNLBLRWCIH	GUILLAUME
FNZO	ENZO
THEVENLN	THEVENIN
TLMOTHE	TIMOTHE
WJNATHAW	NATHAN
WSANTOLINC	ANTOINE
DLYLTAH	DULAN
PSISUENNE	SUZANNE
MSMARYON	MARION
PSMARPE	MARIE
LUCARINZ	LUCARINI
ANGELETTI	ANDELETTI
HWASSELLLLLLLL	HASSE
PLPLANLLTLLIVLE	PLANTIVE
SEGMDS	SEGONDS
LEA	LEA
HAFCELLLLH	MARCELLIN
LLIN	LIAM
MARTLOV	MARILOU
ALLX	ALIX
IWSSALVETLLLLLV	SAVET
TPUULHHRDLLEPAOE	TOUCHARD-LEPAGE
WSULXELE	MIKELE
HRSFLQLMLWLVELNLNVALNLEI	BEMOUENNANE
PSVALEHTFH	VALENTIN
MSGAYVALBLULLR	GAVARD
BREVON	BRENON
TWMAVLANRMESULOLUIJL	TAVARES
BWOLOT	BOLOT
CMWHNSWIEIW	CASSIE
LISE	LISE
FOVTENAY	FONTENAY
HAHOH	HAHON
REVEILCE	REVEILLE
LWEO	LEO
AONDEAV	RONDEAU
ESWAULTILARRE	ESNAULT-LARRE
AWSFOMLILNLL	FORTIN
NATHAN	NATHAN
LWLBFLEL	BILEL
MSLAURSTE	LAURETTE
DW	DOU
LLPSMAXASTQIHIW	MAHASTI
LEA	LEA
LLWMLRTMOIMVAJSJNSEJLVYLIU	TOMASSELLI
ALEXANDPF	ALEXANDRE
LILSLAL	LISA
BMOURBVLUNOW	BOURGUIGNON
WMCMXMOIUDKDIJDTNYJYL	ROBERT
VALERLA	VALERIA
PNPHGFLLE	RAPHAELLE
LIMLLLSTALLBLNELSILLLLL	AGNES
WUWCNIWENW	UCIE
ANNE	ANNE
ETHEL	ETHEL
TWOWE	TOURTE
YIRFYNAUD	REYNAUD
BWOLLCLLKLALYULVJLLLL	BOCKET
NLWLATLHIFLLDLHELLL	MATHILDE
LLLLIAH	LILIAN
WBWIMLWFENW	EMILIEN
LWSWADALWELL	DJADANE
MTLPDLLLCVHLEIFLJTJN	DUCHER
NIIMANJA	NEMANJA
ALI	ALI
LIWIHLAFICLLONYVLLL	ALARCON
WYNAN	NATHAN
FAALEW	FABIEN
WSMAWIBAPTLSTC	JEAN-BAPTISTE
HZ	AZIZ
IWILHLLARLTIRLAFLNCVYHLAR	MARTRENCHAR
DENIS	DENIS
MMLTVVALNYIYBYOVUVVLEIVIEN	VAN-BOUVELEN
PIIISANLJANNLANOHWIIM	ALAN
ABDELMOUMEN	ABDELMOUMEN
SARA	SARA
WSAHLYO	AHIYO
NMSJOLLILVLELTYLLL	JOLIVET
PLELLSE	ELISE
LWELHENLNVULYVVLL	LE HENN
ZOE	ZOE
MWLE	MARIE
JILLNTOILNES	ANTOINE
WUAULT	DOUALT
WMCRHMAIULTLEULTWV	MALLET
OUQUFT	DUQUET
HMLVAZLELASYIWUDLU	HAZEAS
LIMJNZUNILERL	MEINIER
GATIEW	GATIEN
EJLLELAWORLLL	ELEANOR
ELLSE	ELISE
PSALEXANDRE	ALEXANDRE
LOUIS	LOUIS
GAFAWD	GARAND
WXCLEMWWTW	CLEMENT
WBMRFLFLFLMETLVLUELVLVLL	BRIFFEILLE
BLMAMEN	BAPTISTE
CEOSA	CEASA
ALEXHADIE	ALEXANDRE
WLSAVCDIINE	SAYEDINE
IWLTWLLNIWLLLLLLL	TROGNON
XMAFLAH	NAFIAH
CLWNU	CLEMENCE
FHLHYA	EMMA
WEROLN	QUENTIN
LAGIERE	LAGIERER
WMEUXVGVLVJ	BOJTEUX
HMWOROU	HAINDROU
LMAWETI	LANGLET
PMHVLINF	PAULINE
ERIN	ERIN
NAPTFN	MARTIN
LOU	LOU
MIMAXIMEW	MAXIME
BEKTAS	BEKTAS
THFO	THEO
JEANBAPTIJE	JEANBAPTISTE
LLYJNLVLERE	NIVIERE
MMSRBWOLYRNJELVSVYXU	BORNES
HXTHILDE	HATHILDE
COSTA	COSTA
MSLTERLLZLZCLLL	TERZIC
PLWINJNTLLLLJ	VINCENT
LEBERRELEJCUAE	LE BERRE LESCURE
WBONBILIYLLLLNIL	BOMBILI
UWIJIULNLOL	JUNG
PSLLEVRLLLETFLAULL	LERCETEAU
WSADRLEN	ADRIEN
XMCHARUSIIBTRI	DECHARLES- -PETRI
MSALEXIS	ALEXIS
MMSYWVULVRTVLLWVJL	WURTZ
DEFABRITUS	DE FABRITUS
GUIVLIU	GUIVIER
ALMURIBN	AURIAN
WPFNFOWLLLLLL	PINSON
LLLA	LILA
COQ	COQ
STEVEN	STEVEN
PSJOROHN	JORDAN
WMWDNRLWLELLW	GABRIEL
ZANAHLA	ZAKARIA
QLBIUFLNUTBINIW	QUENTIN
QUEF	QUEF
NWARLETLLLLLL	MARIET
WLUNNNTUU	SAMANTHY
WIBARLBLEVLVLVL	BARBE
UMIUALLLAYFLPEL	HALLAIRE
BLAITRE	DELAITRE
VFVIES	VIVIES
MLOHLANDLI	MOHAND
PJELISELJ	ELISE
MSLINE	LINE
BAILLLUL	BAILLEUL
LCBON	LEBON
RAVLI	RAVI
PWOISSENGERLLLL	POISSINGER
BUTCW	BRETON
HWMECYOLBLYURUVJJVITXT	HEGOBURU
MMSRAMOIUVALOYUUAUDYYNC	BOULOUARD
IWSGOUIJOLNLL	GOUJON
LAURA	LAURA
EVA	EVA
MSLYEVWVLLUDVH	VERA
HWARLELL	HARLE
PSLUCDLSI	LUCAS
PWXLEHBOVPUATLLVL	PHIENBOUPHA
DLTHI	ALIMI
XENNY	KENNY
LIANWLSL	LANDOLSI
PIAMTWE	AMINE
JWWUFMIWLLULAM	DWEELING
JVLZAN	JULIAN
ALLAN	ALLAN
CWMHEVSWLMELVLTLLITV	CHESNEL
UAIS	NAJS
FOYER	BOYER
THOMAS	THOMAS
ALCXFNDAF	ALEXANDRE
WSCLEMEVT	CLEMENT
YSDUBREUIL	DUBREUIL
MIHAEVA	MAEVA
DLFBO	DIEGO
WURWV	BOURDON
MPLMRIINVGLWLIWDUDJL	RINGWALD
WIWHNAWLPNHEIH	CORALINE
PSBPTLLQE	BAPTISTE
LDHCLLL	LANCIAL
MMLMMMECNVOAJNHOJOJ	MEFTAH
SCHLENCKEZ	SCHLENCKER
CHILHY	CHIARH
VWLMLICLHEL	MICHEL
DARBON	DARBON
CANDLCE	CANDICE
LEANDK	LEANDRE
PSSABAIEL	GABRIEL
LLEMOINE	LEMOINE
WLLLULAI	LUCAS
MRXAHD	BARRAUD
HIPLOLYTL	HIPPOLYTE
ANLALLS	ANAIS
HLMUBU	HUGO
IMSCLWLILFILZYLV	CLOWEZ
CHAVSSEBCURG	CHAUSSEBOURG
ELMLEONORE	ELEONORE
GWUYOTLTINJNJL	GUYOT
PALAT	PALAT
TIZLIXHO	TIZIANO
ULLEWW	COLLIGNON
PALOLLO	PAOLO
LMSLHLLAYLEIAIGLLIINI	MANGAS
DUARTE	DUARTE
AUETY	ANETY
ENHANUFL	EMMANUEL
ANALS	ANAIS
SERVAJEAH	SERVAJEAN
AHLCRAUV	AMICRAUO
CHTVAKD	CHIVARD
AWLLOUNELLLL	ALLOUNE
ILLONA	ILLONA
MMSRPLFLTVVVRRBLELRLTL	LETURGER
MMJMCMHIUAOHOAURUEITOU	CHAMARET
BASHLRIMIAH	BASHIR-MIAH
HWORLAH	FLORIAN
CLAM	CLARA
LEWW	LE BON
ZOE	ZOE
SWWW	SIHONIN
PLJULGEN	JULIEN
WSSENJAHIN	BENJAMIN
LLXIOUIS	LOUIS
YSUARES	TORRES
VASSAUX	VASSAUX
WRSYORULYWLBJYAUYJY	OUMBA
PSLUCAS	LUCAS
TYMEN	TYPHEN
PSJILUDHIIICIANWILLLIU	JUDICAEL
JULLI	JULIE
PLPLILELRIRFI	PIERRE
MWNELNOWDYILW	MELODY
WSIHLIARA	CRIARA
VOJJELIU	GOSSELIN
LAVANNJER	LAVANDIER
PSFLISA	ELISA
MNWNHAWILLDEHM	HADHILDE
CUNE	AMNE
LYSDULAURFJNISLI	DULAURENS
GODLN	GODIN
DLPORTSAHPARC	DE PORTSAMPARC
LMMSMTMAIVLJEDAWVLLI	TALEB
WSCHLOE	CHLOE
GWULLOUASLLL	GUILOUAS
OESCAVCS	DESCAVES
WSWTK	GREGORIE
ROWIN	ROMAIN
OEHLERT	OEHLERT
VEROIER	VERDIER
COORTE	COURTE
CMLARN	CLARIN
PSYOHAN	YOHAN
LADIRAT	LADIRAT
ROTXY	PATRY
CARLA	CARLA
VALENTSN	VALENTIN
ELSA	ELSA
EBNZO	ENZO
ALBALAMJO	ALBALADEJO
WPAISVLVNRVL	PAIS
DPJIBRIL	DUIBRIL
VLLCTWIA	VICTORIA
QUEDTIU	QOENTIN
WIMHWE	ROMANE
NATHAN	NATHAN
WSNURCRE	AURORE
WSKEVLNJ	KEVIN
PXWEW	PHISBIEN
LESLLE	LESLIE
WMELCARESO	MELGAREJO
FORWES	FORNES
HNATS	ANAIS
WSROAAW	ROMAN
RATMHA	RATREMA
ANWEA	ANDREA
WLLALCHC	BELLAICHE
WSTHOMAS	THOMAS
LPEROY	LEROY
ELISK	ELISE
MSHANON	MANON
WMSPDWAIHUHUAJLLJLJTL	DAHMANI
WWLMMNISUNYLSCZSIML	DENIS
WSLLABLEILLELT	LABELLE
FAHIM	FAHIM
KLOBANUVIIC	KOBANOVIC
RWAULTLLLLYYL	RAULT
CODZWTIN	CORENTIN
AUFIL	ANGE
BYAYOUT	BAYOUT
GLJLLDNAM	GUYOMARD
LHLULKLT	LAFORIT
EWIN	ELGIN
WLPULOVVZLOIDVDLOOYWLP	CLASSE
CLLEYMENCE	CLEMENCE
YABAS	YABAS
LAGPATHE	AGATHE
ALVSSA	ALYSSA
CENEVIEVE	GENEVIEVE
LPICULLIGNON	COLLIGNON
THEA	THEA
MALDE	MALDES
LLPIILLLILLYIEJOLIUMWIM	LISE
HAMDOUN	HAMDOUN
TLWHOHAS	THOMAS
MWRWLLLL	BARDOU
FAUASLV	FARCASIU
FLORA	FLORA
MHONTEFST	HONTEIS
YINHLS	YANNIS
MRSFLLEIVVYLWUUVL	LEVY
YLALLX	ALIX
AHFILI	AHEUFJ
MEWDNNOUEWILW	EDWIGE
IMLJEALNSLOLULVVIONL	JEANSOULIN
JLWIEALNNFLEHLH	JEANNE
HMANHLEU	MATTHIEU
CLAPA	CLARA
LWISDRIS	BORIS
NJWON	NINON
WLVLCTOR	VICTOR
HHKTM	HAKIM
AWWLEMHWHDNNW	ALEXANDRE
SHIRLEY	SHIRLEY
TMYHONMWASIW	THOMAS
QUENIIH	QUENTIN
RASILLLAAFNUN	DA SILVA ARAUJO
ALLHYENE	AIMENE
DILAAUU	DIABOU
LFIGIUIIEHYIEL	GUEYE
BOZZETTO	BOZZETTO
TLIMOTE	TIMOTE
HMSJEANIZLYALCLYL	JEANZAC
SMJWFSNYEIVLXIVN	SILVESTRE
NWLCHARPFNTGEP	CHARPENTIER
IWMLRDNALRYWLVLLIINN	DARDEL
BFSSOWNET	BESSONNET
FWAJH	ROMAIN
MMLYSMELMVEJDJWXJYAJVVARES	SEMEDOTAVARES
CWRTIU	CHARTIER
PERCLO	PERCIO
LOUISE	LOUISE
JPAJAND	BRIAND
RWLVILIGINOLILIL	VIGNOLI
DARDLLLAL	DARDILLAT
PSLJA	LISA
WWMMFWAWW	DORIANE
WSMARINE	MARINE
CLEMENCE	CLEMENCE
LLWIAULRPFNLLCFL	LAURINE
ELYAZALI	ELYAZALI
UMUJWH	ZOUINA
WFIEY	FIEY
WSCAULLLC	CAMILLE
CWLET	CLET
CASSFNNA	CASSENDRA
MMSMMCRIUOONBJZIIYDJAS	CROMARIAS
IMSFLOLWLZLFLXL	FLORCZAK
HARTJNLL	MARTINI
AWISH	BAPTISTE
CLWIHALQWLTTIELH	CHARLOTTE
MBCAYMIWLLEAW	CAMILLE
AWWMOMWYRW	AMELIE
DIAVTOWZ	D'ANTONI
MHYTLHEZ	MARTINEZ
WMWNWWNW	VERONNY
PLMATTFO	MATTED
ALISON	ALISON
MLAACIHFL	RACHEL
MSLPRIILSLETLTEL	PRISETTE
TROTEL	TROTEL
ANTOINE	ANTOINE
ACTRY	ACTRY
LOULLJ	LOUIS
AZHARL	AZHARI
MMZTHNELRLKLOLVLLLYCLL	MERKOVIC
WM	TOCH BEGRAM
MALWFNN	MAIWENN
WUYER	ROUYER
BONCONPAFN	BONCOMPAIN
PSJAMLLL	SAM
LMMLPKVWLYDVOUUVVUVL	KEDDOU
WELNBERC	WEINBERG
MLLSTLLLAPVOLRVTYEYILL	LAPORTE
MLEGEAYLL	LEGEAY
WSAARLA	MARIN
LENISFLLIE	DEMISELLE
FERLRY	FERRY
HALLLYWF	HAILYNE
MLYSTVLALRYOLCUVHELJII	LAROCHE
LLMMSRLMULZEJJUVPL	LUZE
YSCILAOLIVLIANTRUOWG	CAO VAN TRUONG
MMIRHNALIWYXUUUJIL	HADDOU
LLPSLCIADTURO	CASTRO
PLAMANDINE	AMANDINE
MIWRRIHNWANM	IRINA
IWGYERXYLYMVVVII	AGNERAY
PIISOLGHILWNFOANONWINM	OGINA
COOLHOURON	COUCHOURON
RLWLPO	RIBEIRO
VARTABEDIAN	VARTABEDIAN
EPUSMHE	EUSTACHE
WMUWNAWYLILVNYL	GOUVENAUX
LWLFORAY	FORAY
PIDELIPHHLAEL	DELPHINE
CLARA	CLARA
IDRIS	IDRIS
HANOTAUX	HANOTAUX
CUYDRD	BOYARD
DWLMUSULLI	MUSITELLI
AGHSH	AGHSH
LLLZMJNIZ	LEMOINE
WWHELNEUNEWILH	HELENE
LEA	LEA
ELKARBHSS	ELKARBASS
ZIDANE	ZIDANE
ANLOLUFK	ANOUK
PLYDUSSEF	YOUSSEF
JEAW	JEAN
LYSTHLBAULT	THIBAULT
HWHLBNLWNNW	ALBIN
LWLDOCVHLELLLL	DOCHE
JEANJE	JEANNE
LWNIINLALL	NINA
WSAJLA	AJLA
UDWLALLL	DONIA
JASPER	JASPER
IWNAYA	INAYA
HOSPTTEI	HOSATTE
LAURENT	LAURENT
MWAWCOLSLLLLYLL	FRANCOIS
PHGCUS	RAGEUS
TLMOMY	TOMY
BINLJAHIH	BENJAMIN
CREWIRE	GREGOIRE
CENEA	CETTIER
IMSHELLJSLSLAVIYL	NELISSA
MSMACYWYLURVDUVWJI	SALMON
MPEIRIN	PEIRIN
LLLWVUUWV	ANTHONY
NATEO	MATEO
SDNIHEZ	SANCHEZ
TILBHRBWXE	RIBARBACHE
LCMSGAYTAN	GAYTAN
JWSLLECYVWIULELLLL	LECOGNE
LMATPHLOFR	LATIMIER
WSLOUFS	LOUIS
DWELOBEQTVVFVLLLT	DECOBERT
CHILH	GHIN
HORGANE	MORGANE
WSLAURA	LAURA
MCLUKAS	LUKAS
BELBACHGE	BELBACHIR
MMSMDMFLLVOAUVUYPDBX	DELAVY
EMMA	EMMA
PLTVU	RIZQ
CWWRREL	CHARRE
IWSLAULRYLLE	LAURY
ALEXAADAE	ALEXANDRE
VANHAREN	VAN HAREN
NWSLLEGLRIAYNLDLLLL	LEGRAND
CWWLDMWW	CLEO
SANLIA	SAMIA
SAUTHON	SAUTHON
JCLY	JOLY
MWALINEWNORIW	ALIENOR
LLWMLLWNJUOUYYTOQXL	AOUN
WARH	DUARTE
LUCHS	LUCAS
ZAMASSE	DAMASSE
WFPLJEIRESCHULZ	FILERE SCHULZ
BWELABBESVILLIDVV	BELABBES
XWLNGUEROUUIIAYUSLVUELL	KINGUE MOUAIIGUE
DAXLEL	DANIEL
MNLN	NONIN
LPSLIIINLAHIHHLLLIH	LINE
QHELVIENHW	STEVEN
ENORA	ENORA
MSNOUVSLFLLLLL	MOUSFL
MMSMTMAIMVOINJLYJLN	JAMON
MMEHHMAWCW	EMMA
EWWAHNAWIW	EMMA
CHALAYE	CHALAYE
LNMSLFULRBLALVLLLLTIVI	FOURBAULT
MWLCHELVILJLIIJ	MICHEL
ALMMBNOXISQ	AMBROISE
ROHE	ROMEA
DWORGES	DORGES
LESRREC	LE SERREC
WSFRANCLE	FRANCE
PSNATHILS	MATHIS
LMLPIERRE	PIERRE
STANLSLHS	STANISLAS
LWEE	LEONIE
DUFFET	BUFFET
REMF	REMI
BREMAUD	BREMAUD
EWWNLNLWLENW	EMILIE
LLWSLOUNANNE	LOU-ANNE
MMSALLLJEL	ALIJE
ELLNLLILIHS	ESTEBAN
YWSUMIUUSDJAUYSDN	LAUNRAY
LWMSSROLULSLEVLLEJTVTL	SOUBELET
WWET	MIGNET
PSCHYIIDEN	CAMILLE
IBLHILLJLWIHDLLFHLH	FAGRECE
WSLE	LEO
MZLLWN	TRISTAN
PLALWLS	ALEXIS
PMLPPVSLLYOLNLAXYLY	PSONAK
MMJRLMELUVBJAIIDDII	LEUBA
WMSPVPELLHRLLLNLYLLI	PERRIN
WSHAUERSPERGER	HAUERSPERGER
ASCASSANDRZ	CASSANDRE
NAETIUS	MATRIUS
LDCFANW	FANNY
DWOHWLA	DAHLIA
GLOROANO	GIORDANO
MLMOW	MIMOUN
ADRLEN	ADRIEN
BDUDU	BOUDET
LMLLLSTPLLWVLLURVAVVJV	PRAIRA
MLNATHAN	NATHAN
WMDNEL	GEORGE
NWLLYAYLIIIVKVALHLIV	YAYILKAN
MFBABWLWOHW	PABLO
DMEZEAU	BEZEAO
WSHAMTA	HAMZA
WSBERENGERE	BERENEGERE
PSCLFLIE	CLELIE
MATHIS	MATHIS
TLDELAVALLE	DELAVALLE
LOBERT	LOBERT
WMIPMDLIOVTVJVVLVIB	DIOT
RMREBLOFULYYVVLVVUI	REBOUL
PSNOENFE	NOEMIE
MENU	MENU
MRAPPLLLLLVYL	RAPP
WYURTEBJSELLLLLLL	HURTEBISE
LWDLAMJIWFLL	DAMIEN
CVKLLFS	CUBLIER
HOAZANE	MORGANE
LFSLI	NOM
TLWLHEJLLLLLLL	THEO
MCREAU	MOREAU
CHLOE	CHLOE
WSCLSPHH	CLEOPHAS
MPAWIJACQUES	PAUL-JACQUES
PILISA	LISA
LEWILLJIJCTJIU	ELLOIT
LPSLUWE	LUCIE
JWWADMEWRW	JADE
AUMNWNJUUNAILH	ANGELINA
ELTER	ELTER
LUJU	HUGO
UYHMAR	LAHMAR
PWECMWVILLLLL	PECHARD
BENLAIX	BENDAIX
HRCMER	CHARLOTTE
DALWASO	OALMASSO
LPSLMLLFJK	LAGIER
IMSGLLLESL	GILES
HMSTOMLASLLNLLFT	TOMASINI
CARCIA	GARCIA
OMSNLIHIEALUHE	JOUSSEAUME
HLLA	MILA
RCCERSIFNHETTE	ROGERS-ANNETTE
LPLBWWLEWLLL	BOUDJEMAI
WSUALRE	CLAIRE
NWIDERLGNL	BERGOT
LHIMOSE	MOGE
CORRLLER	CORBIER
WL	AUGUSTIN
JLFLELIRRLLE	FERRE
WWTHJMWALNM	THOMAS
ABDPLKHCEMSAXE	ABDEL REHEEMSAYE
WSYW	EMACK
MAELLE	MAELLE
MMSPPMALOVUVVUVVCEJJL	PROVENCE
ALLLLIISON	ALLISON
LLPLPITAULT	PITAULT
PSJOUAS	JONAS
PSCDANLB	OSAMA
MMSTRCTLVLVGOJFLLLOJRJN	GRIGORION
PIAYMDIC	AYMERIC
MMLYFVALYUDLELUUXLIHL	FAUDEUX
SZLLOU	SILLOU
DIAPTIJLE	BAPTISTE
PIBENJAMIN	BENSAMIN
ILWSWRE	ISAURE
WSGARDNCE	GARANCE
AMBLRHXWANDREAW	ALEXANDRE
LWLMANUEL	MANUEL
CWHLW	CHLOE
LWSEDWARD	EDOUARD
LWLSON	LISON
PISUN	PISTIEN
MWSMHMHIUMVLAJLUFRJFDJV	GAGNAIRF
LLNOUAH	TITOUAN
WZBFLINDA	BELINDA
JACQUENLN	JACQUEMIN
LAUUNE	LAURINE
AWBJTMLNWLNENW	ANTOINE
FWWLILMCWLILFCW	ALICIA
LDSNELILGNANL	MEIGNAN
GAELLE	GAELLE
CLFMENT	CLEMENT
SEAAE	SERRE
BWMUPYBLULMWVIGGLYND	BURGUN
LPSSUWLNE	JUSTINE
LPLROXANE	ROXANE
MLWEANWNW	LEA
MMSYLMOIUUYAJNGINDUI	LOUAMI
FSAH	ISAAC
MMNFRWNYUYLLIUL	MONERON
SUANEL	SHANEL
FLAMELL	FLAMELL
WSPHJWHFXF	PHILOMENE
WSGIOVAHNI	GIOVANNI
WIRAEXLELBOOM	RAEKELBOOM
BCFDEMN	BORDERON
HMNITIEOHW	MATTEO
LPSISAUREL	ISAURE
WSCCWNTLN	CORENTIN
PITHFBAUT	THIBAUT
IMRIFPVLLEVTLLLLLLN	PLET
MMSTVLFLVFUVRLLVLL	LEFUR
OCEHNE	OCEANE
KWLLUSLLLLUVJVUDIU	KUS
WSJULIE	JULIE
SWWARMAWHW	SARAH
CELINE	CELINE
LMIRLYA	TYA
THOMAS	THOMAS
MMSMMSAIBUJFNSUVBNU	SABIN
REIWACLDO	REI PLACIDO
MSRALTHUS	BALTHUS
ULJEZ	GUEZ
JMWADNEWNU	JADE
RMOBQVIN	ROBQUIN
LMSLBLLIELNLALWYSLKLILL	BIELAWSKI
PSEHNAILLLIIHLL	EMMA
IJCJFS	LUCAS
DFCHUNES	DECAUNES
MATHFE	MATHIEU
NAOISON	MADISON
VICTOX	VICTOR
MMIFPRELVPDIRJUEIAUILV	PERDREAU
MMSPDMUIFVATLOGJJTR	DUFAL
LPSHALKLHA	MARINA
BWEKWAOVI	DRENOM
MUNADS	HOUMADI
PLSCLLDUZADEIIWIW	CLAUZADE
PDFM	ADAM
CYRLELLE	CYRIELLE
PLCHLN	CHLOE
ROXALN	ROMAIN
NAPCLO	RAPOLD
WDLLELNLLIELFILILLLLLL	DENZEL
IHWHOHIAWHEDWALIQLU	MOHAMED ALI
MSWVHLYELWRVWSW	ROCHE DUCHESUE
PAEHAEJL	RAPHAEL
WLNAELYS	MAELYS
THIBLULL	THIBAULT
AMLYARKFLSDLOLLHK	YAMKILSDONK
LWSJULEAN	JULIAN
WSMAXENCE	MAXENCE
PSJOFGANE	SOFIANE
WSDFNAUD	ARNAUD
KARDLIWA	KAROLINA
MMSRLMEICVHVPJLILTVAJJTNUF	LECAPITAINE
BOUCAPT	BOUCRET
HLPAOYSON	MADYSON
LIWWIISCELLJIVIAAHLMMILIM	CELINA
QWFCHWVVLLVWLI	RICHARD
PLCLLFMENCE	CLEMENCE
WSROLGLFVTLL	ROIG
TIPHNINE	TIPHAINE
ADLEHE	ADLENE
HAY	HAY
VOLNELS	VOLDERS
LPLLENAIE	LENATC
WESHLLUE	NISRINE
YLIDLZ	YILDIZ
DMSDEBARNOT	DEBARNOT
LLAF	LEA
MMSTJMALVWLOYVVVJN	JANYY
PSBLAPTTSTE	BAPTISTE
PLLCENLALIWL	CENA
FERRANDUGEISLER	FERRAND-GEISLER
NATUAV	NATHAN
PIMAWON	MANON
TUOHAS	THOMAS
PIISALOJBILIINNRNWIM	ROBIN
AWBOALIAHLTILLILL	ABDALLAH
WSVAITIARE	VAITIARE
HERY	HERY
W	YANN
BLWWU	BLOMBOU
PSRENAUD	RENAUD
NWETUSLLLLYLV	PIETERS
MMLMDMFSDNFYDMOITYB	NOM
LUDLLHCB	CHBILHEB
RWLFWLELLYVJLLIVUN	RAVEL
PSLELIILEIIIN	ELIE
MMSGOUPIL	GOUPIL
RIO	RIO
AMELIE	AMELIE
DYLANN	DYLANN
DHELAGRANGE	DELAGRANGE
MMSMWOEILUDJYISFPJDJFIY	DELPIERRE
PIEHELLNE	EMELINE
PSIJIFANDEK	ISKANDER
SLACHA	SACHA
EVAN	EVAN
WCDERIAN	DERIAN
GERHMN	GERMAIN
UWET	MOUTET
MSERWANW	ERWANN
UMLISE	LALISE
DEPONTHAUD	DEPONTHAUD
WWWNMHW	FRANCOIS
HHIOLLET	HIOLET
WMANVJA	BHANUJA
WSANAELLE	ANAELLE
AMF	AGATHE
LPEONJE	LEONIE
PIDLERRICX	DIERRICK
NLCXNNDRE	ALEXANDRE
JWIHUCIIHEWIH	JULIE
WMLSMMTWELIMWI	ISMAEL
ANLISSA	ANISSA
LEANE	LEANE
PPAULINE	PAULINE
MHELLEUX	RELLEUX
HDVHANNILSYAN	HOVHANNISYAN
ULLLVEAU	JOLIVEAU
LHONME	LHOMME
LAMDERT	LAMBERT
EMLSCHALINIAIINWIIW	CHAYMA
LWMSYPMIICVHNAJVVADNVTYLZ	PICHAVANT
PSNELODLLE	MELODIE
DEPLACE	DE PLACE
POIRFEK	POIRIER
MWWUMRELMSUDHUUJLL	FOURES
MSAUGIER	AUGIER
UGO	UGO
BWRARLDFIWYETVOIVYJV	BARDINET
SATORP	SATORA
POUPLLN	POUPIN
CWRLNON	CRINON
OFRZHU	OPHE
PLLLEJALLLIIWLH	LEA
WAWNNMWINECW	ANTOINE
TULIER	TELLIER
ABDFLLAHILUQUET	ABOALLAN-LUCUET
NAUOON	NAUDON
LOANE	LOANE
WAWRNWOWIW	ARNO
WIEIJIER	GEISLER
MSBAUVEFLLI	MAUVE
LAMMWE	AMBRE
PILPLLWIIRHLICIKL	PIERRICK
PSLIHHJILLI	SAMUEL
PIHMAL	AYMAN
MSCLARA	CLARA
TMRHELZLERVLJDUUBI	THEZE
PSBAINLML	BAPTISTE
IMSAWNQFWMWLL	ANDREMONT
SWUNDARAIVLNVVSAVMVVLL	SUNDARAZINGAM
CNARDDKKQ	CHARLOTTE
WIAUREPLLE	AURELIE
LPCJIJEASHIL	DURAGHI
CLAFA	CLARA
WLDLOUAW	REDOUANE
MANON	MANON
LMMSMMUIOYIIJJHJUYY	SADIQ
NARGHUX	MARGAUX
BSRAJALOLNILALL	RAJAONIA
TALAHARI	TALAHARI
LASIAXITE	MAXIME
PSMARIELIESSE	MARIE LIESSE
WLLLWLALSSYYUJVVVJL	LUGASSY
WLFOMLLELSLLLILLL	FORGES
AWMPONLWLLWNW	APOLLINE
MACFO	MACEO
ETIENNE	ETIENNE
GOLGE	GOUGE
FOUSDARU	FOUSSARO
MBCAHNHWLLEAW	CAMILLE
RLGORD	RIGORD
WHM	TRANCHAND
FLORILN	FLORIAN
HZDFAI	MEDFAI
BWRUIANTLLLL	BRUIANT
PSALBRLCLLJ	ALARIC
GIRARDIDEVHSON	GIRARD DE VASSON
MAWNHHWLLWNW	MATHILDE
BCZCE	BCICE
FLSCJYPIIIELRES	CYPIERES
XORANTILN	MORANTIN
WMW	ALBAN
BOUCHER	BOUCHER
THEO	THEO
JWWEAMNWNENW	JEANNE
NAJAILHA	NORELHIA
NLILLSLH	NILS
FOLLFN	FOLLIN
ABEILLARD	ABEILLARD
GAOUEVAN	LAOUEVAN
DOHLNGUEZ	DOMINGUEZ
WSTLWOC	THOMAS
DRLJARD	DRIJARD
LMMSTHVFLVRRHYJLVJLL	HERRY
WWIMNEINOGAZIOOOLTL	nan
PYEVOW	REVON
PIILSILRAUHROAINALNWIM	LAURA
MMLTNBFLRRILAYLLIYL	BARRAY
JORWN	JORDAN
ALWWELC	ANGELE
FSIWLILLKAV	VAILLANT
TYOLZA	TOLZA
YSCALURI	CALURI
PLSNKIILLFANILILLJ	KILIAN
NOA	NOA
PSCEFINE	CERINE
PCAAMC	ROMANE
GWUILBAUD	GOILBAUD
WSEMMA	EMMA
PLLCLRRALNE	LORRAINE
FLORLAU	FLORIAN
WLRANU	WALRAND
IWLSLYMOLNLLLLL	SIMON
MWLMMDCILTUUFFULYILYL	BOIRE
NAXINF	MAXINE
SASON	JASON
LHURH	LAURA
WLLPETLLITLLLL	PETIT
AUTHUH	ARTHUR
CLPLAM	CLARA
VICTOR	VICTOR
CORBIERE	CORBIERE
RWSDELASSULSLL	DELASSSUS
BLOUET	BLOUET
ZOE	ZOE
IWSLELLLWLAXTLILLII	EL OUAKILI
LPSWLYUHL	WINUM
NPATEO	MATTEO
PSTHEODORA	THEODORA
SAXM	SAYAH
GLASYPARD	GASPARD
BOVVIIIY	BOUVERET
SALASIPEREZ	SACAS-PEREZ
JWUERYILLLYLLLN	JUERY
LANDAEAU	LANDREAU
VEOUX	VEJUX
EWISA	ELSA
RNOMAS	THOMAS
EFONLU	ELANIE
NWALANTSF	TALANTSI
ARCUEL	ARGUEL
WSMATTHIEV	MATTHIEU
MTLLNLALFVINLFDZVTUJL	WAGNER
JAJUUT	JACOULOT
PLEMW	LINGOT
MSLWIVLNE	LUDIVINE
MILFLOSVSLALTLILIVL	FOSSATI
WSLLLOU	LILOU
ILIC	LUCAS
IWLZHFNCF	CLEMENCE
HOGUES	NOGUES
MSLYNE	LYNE
WSSLXTLNE	SIXTINE
DEKNUYDT	DEKNUYDT
WWLAOQUET	DULROQUET
BLEATHWD	BERTHOOD
BWOUCHEREVAVULVLLLL	BOUCHEREAU
GULLLAVNE	GULLAUME
PICLARA	CLARA
PSWVAFN	RONAIN
PSAIYINIEHRILCIIIIHLI	AYMERIC
ISWHERNVWANNIW	SERVANN
PAUL	PAUL
BWRASSEINVDDLLDVLLI	BRASSEIM
LWLYSYCPRLEVTLLLNLOLNVIV	CRETINON
LWLIBILVLLIUOLNLYLL	BILLON
WDEUOUJLLLLLLL	DELCOURT
GWNRD	GODARD
LPSLWLISIL	LOUIS
HAXLHE	MAXIME
PSFUA	EVA
MLCLARA	CLARA
XLYAN	KELYAN
CAMILLE	CAMILLE
WSYNIS	YANIS
PLVIELCITHOIAITINIELLH	VICTORINE
DMJRIBEI	DORIBE
GYAHQLL	SAHALI
JULLE	JULIE
PLLOULS	LOUIS
PSMIKA	MIKA
CMWLMIWMNW	COLINE
SIBLENY	DOBIGNY
VWIDALLLLLLLL	VIDAL
PSCELJLH	CELINA
IMSLVLLOYLUVLNTLAVRLINO	VOLUNTARIO
PENET	PENET
FLORLIWE	FLORINE
DMSFONTOWLCZ	FONTOWICZ
LLPLLSRIPRHRIILWLU	RIH
DELTCUP	DELTOUR
MIDUSALRTLL	DUSART
WSLVLLLLLILLERELV	VILLIERE
AWWFNMWZNEW	TPORINE
MLMVCLALFYFLVLYUVVRN	PACARY
ELPVA	EVA
NINO	NINO
LWMIMWFYTZFGF	CAMUF
ZEFIE	ZEIZE
MSEFNARFANOYNE	BENAFA MOYNE
WWAYOMUWSNM	AYOUB
PLFOUHLDHTGUEEZ	FOUKDRIGNIEZ
IWLIIW	LANA
VMSCAMVALNRAYVVVL	CAMARA
LORIS	LORIS
HFEGTCACCL	MAESTRACCI
MMIMLMLIVPYDCOZLZOM	LEBAS
CALMELS	CALMELS
MSJLIE	JULIE
PLDUEQEY	PIQUEREY
JMSLFRALDLLINYLLLVI	FRADIN
HWMWNWNM	ALEXIAN
NMSLEVFARUICVEULXLL	LEFAUCHEUX
FILEUR	FLEUR
WMXNALXN	BONNEMAISON
MAUREL	MAUREL
MMAGUMLLIMONVJLLJUJJ	AGUILON
MCAUD	PACAUD
LMLVANHOLUTTE	VANHOUTTE
CWHAUVEL	CHAUVEL
ILIIL	SJIEP
LMLYITMLLLLCYHIEVLLLLLV	MICHEL
OIWHEOIFUFQWEYLIW	GEOFFREY
MWSGALLDRMLONTLVL	GALAMONT
ELSA	ELSA
HADEF	HADEF
HBNLAINHW	POHAN
AMBDANMWNW	ADAM
MLYLTHLLULVITUUUVTVVL	MOLTON
MVLCHAL	MCHAL
WWIUCWNSRCTCPWDSY	SASSI
YHALLLPRF	HALIPRE
MWU	TOUZET
GABLILLAT	GABILLAT
WPLNMUIUUTJDVFZFJUUV	MONOPIFE
HALHEC	MAIHEO
FIWWLOIFWENTWIW	FLORENT
LNLHY	SABRY
PSROHAIN	ROMAIN
FONS	FONS
IWLOIUNWHW	LOU
GREGOLIRE	GREGOIRE
WMSSETLLL	GOSSET
SEFHOUR	SEGHOUR
FWM	FLORA
VARTY	VARTY
LMERHE	LERALE
PSYAWIAE	YASMINE
SEDIFO	SEDIFO
NARTLNS	MARTINS
IWMIPCVOLRLDTELLAUVLJY	LORDEAU
GUILBEBE	GUILBERT
FWYMMWW	ENZO
FELIRX	FELIX
PILWNLMYWVIDLLLW	BERNARA
EWOAANE	ROMANE
PSGEROUDL	GERAUD
SAPM	SAIM
COLINE	COLINE
CWWYNMTWHIANW	CYNTHIA
GRIVWU	GRIVEAU
LHSLEO	LEO
PLCELJA	CELIA
LFSHILI	LE SAIIT
PLIIHLHOUALASANNJNMINM	LOUIS
LOUIS	LOUIS
LMMSMMRFINUTLFJXAGJJABL	BENZERGA
BOTREL	BOTREL
ANPEET	ANEET
GASSAHA	GASSAMA
BOULILLETLE	BOUILLETTE
LAHVS	CAMUS
WMIMMNDIUVYVGCDFY	DAVY
MSLAVMNE	LAURINE
WWUUMLSWENW	LOUISE
WMJMBMOIUVRJVSUEJUYV	BOURSE
QUENTLH	QUENTIN
ELLIFAS	ELIAS
KEHYHOLVEC	REMY HOLVEC
PSARMWD	ARMAND
LMLLTOULHIALILLUV	TOUMA
AYWSC	AYMERIC
WWSATMIWVEAM	SATINE
MORGANE	MORGANE
RORSLN	MORGAN
AEHTHE	AGATHE
CARLA	CARLA
MMWHWLHMI	MANON
SORLA	SOFIA
WSLHOYVTLAVWLLELIL	HONTAGNE
VISM	TASHA
PLMANON	MANON
WMHHOULIUJILUJIO	KAHHOULI
LPSDULVALLL	DUVAL
HAHINA	HANNA
XLOU	LOU
WMOWHEAVX	DEMONCHEAUX
CAUDICE	CANDICE
PLFRLLOYVIVLLYL	ROY
DESTOUCHES	DESTOUCHES
HLILLET	HILLET
MMSTHVALYREIIHLTVDLL	HARENT
LDWSROQUFS	ROQUES
MLCTSLLYWJLDLLVVLL	SYNOLD
REAL	REAL
HAESE	HAESE
PSCELILHL	CELIA
LPSCASSANDRE	CASSANDRE
TLLMNT	TILMANT
TRHUENOUX	THEVENOUX
TIRANE	TIRANE
WSMAURYWE	MAURYNE
DSVFVIOLS	VIVOS
LHWLAULDFILFL	MAUD
XEZPMUSSOTF	KEIPMUSSOTT
PAHW	RAHHOONI
PSMARIEL	MARIE
LYNA	LYNA
IWSLTHLOLRLYYLLVL	THOR
NWLIEYLANI	CEYLAN
IWLLPLEVRPLELVTILR	PIERRET
GOYEAU	GOYEAU
EVPM	EVAN
BARNABE	BARNABE
ARUEN	ARWEN
WMWLNWWFNNHW	MAIWENN
BMELABBESL	BELABBES
ELWNMA	EMMA
UELL	ZOE
WWWMMWHCW	SARAH
WLWTHNNV	BIENNE
VALLEE	VALLEE
LOUIJ	LOUIS
GAETAN	GAETAN
PSFTUNJOM	BRANDON
GILLES	GILLES
PSMANEL	MANEL
YIBIIEAHXH	BERMEJO
NLICHEL	MICHEL
MANNONL	MANNONI
AWLBERTO	ALBERTO
LUUHA	LOUNA
WTERKL	TERKI
IWMSYCVULUJVAYTYVYL	COUJATY
WMSMMNFIUDLLSDNWNIZYH	BERLANDE
FWORETLLLLLLLL	FORET
GWIULIA	GIULIA
LRHSF	CLARA
MJBIENHAAKATE	BENHARKATE
MMSMLMVITULJYRFJYRTUUDLL	GUTIBERT
LYSLOLSLOIN	LOLSON
CPAPAO	CAPAO
PWX	POUX
BATIHE	BATIME
LWVIFDLLUVPILLELSVSVIISLI	nan
LANUTTE	LANOTTE
AUDREY	AUDREY
ALICE	ALICE
ALFZEE	ALIZEE
MMSMBMEIURTVHYOUULVLL	BERTHOU
OOULLLET	DOUILLET
MMSRMFOILVUILLJLIEOVVL	FOUILLE
PSYAN	YAN
HOSNI	HOSNI
NWWIF	NOEMIE
WWAHINNWENM	AMINE
BRUYTRI	BRUYERE
LUWSLOLXSYARYDLVLL	RONSARD
WIJULIE	JULIE
UNME	CANONNE
WLTLRRALYLELURVLIUN	RAYER
PSMARILE	MARIE
HMWAPHIWEHM	HARIE
WSSAMI	SAMI
SWWHANWWEENOW	SHARLEEN
RENY	REMY
MSNAMLALOLUIL	NAMAOUI
WANL	ADAMI
PDONJ	PONS
MBCSINAWRNW	OSCAR
MIMLTLNELBVELSIIVOTNVDIDLECOATPW	LEBESCONDDECOATPON
GWUAQULIERELLVYLVVL	GUAQUIERE
MMSMCMHIOUYHNLEVTJXOH	CHOBLET
RWWHLLFLL	ROTH
WSDYLAN	DYLAN
CUGNET	CUGNET
PSELIO	ELIO
WWEUNMAWOW	LUNA
MSALBAN	ALBAN
ILLLMUIL	COLOMBE
PICISNLNAZRAOKIEAOUWLM	LAZARE
SOPHIE	SOPHIE
OLLVLER	OLIVIER
LROIVTF	LOINTE
UU	LOU
WWIMUWCSVOMAHBUSZBGF	HEYMAN
FAURE	FAURE
PIMYJSL	MAYLIS
DMALMASSOLVLLLLL	DALMASSO
LXRILIIISILL	NOAL-JAME
PLCARD	PICARD
PLALLCLA	ALICIA
WGEHALSLL	GERVAIS
EBIJLO	ENZO
DELALANDE	DELALANDE
LMONANVVVVTJJI	CONAN
FLWSMA	ESMA
EHHA	EMMA
MAYA	MAYA
PSAXIELLL	AXEL
AMLBERLIISYXLLVLLL	ALBERICI
WARA	CLARA
MLCRELSLPIOLLLL	CRESPO
MSAULLNE	PAULINE
WSXENALRDLL	RENARD
KWWYLMIWLANW	KYLIAN
WLLAVDD	DONNI  LAURA
CXFZUT	COQUEIUT
MMLYRHVLVCHJEVITVTVN	HUCHET
PLCHRLSTIANE	CHRISTINE
CRLIZER	CROIZER
JACOB	JACOB
PSNAXLME	MAXIME
LAJII	LOVIO
MMSTAMAIYVNOADVUDVNIT	RAYNAUD
GUERAM	GUERARD
UILLYAN	KILLYAN
WIANANDLNE	AMANDINE
JVLIENE	JULIETTE
MSUORGANE	MORGANE
NATLS	MATHYS
PSARNAUO	ARNAUD
SPONONL	SPONTONI
MMZTGVULVLIILILLELUMFLBLR	GUILLEMER
FWMMPLNMEULULIYI	LAMINE
LAWUETIN	LANQUETIN
LHSWLANOTLER	GRANOTIER
CVN	EVA
MVSLYDLLECLOLULRTLIVSLL	DECOURTIS
LPIISNNANLIHRIGANSNLNWIIM	MATHIAS
PLCUMBLARLEIIT	COMBARET
JMWADNEWIM	JADE
TYOURATIER	TOURATIER
LLPSCREUSOT	CREUSOT
AGATHE	AGATHE
IMSLHLYLVLVEYNLOTIVSL	GUILLENOIS
PETIOT	PETIOT
WIHAUEHA	MADJERA
WICLAIRE	CLAIRE
MXME	ROXANE
MWLEANWHM	LEA
EWWLOMFIWUNW	ELOISE
CLFHEWCE	CLEMENCE
PSHADBEH	MAOREEN
SMBAKNLWNAHM	SAKINA
PSCLOVJS	CLOVIS
LAROUHAONE	LAROUMAGNE
WBDFNNAN	BRENDAN
WSALNME	SALOME
DOPDLER	DOPPLER
PIEINIZIOHAIINLWH	ENZO
YAHUEL	SAMUEL
XFANF	OCEANE
JLNCNEZ	JIMENEZ
MMLTWMLLZDIJWVJYJVLL	MARTIN
JMDJLMEWSW	JULES
WJWADNEWIANAELHLME	JADE-ANAELLE
PROVOST	PROVOST
BMDU	BONDU
ALTUNA	ALTUNA
TMREPARXLILLLLL	TREPART
LMSSCHLOVELSVEYRVYU	SCHOESER
WSLUCA	LUCA
MPASSE	MASSE
LYEIVAJHHLH	EVA
RWMUDWLOIMFFUYYYTYYL	RUDLOFF
LFSA	LISA
JUAR	JEDAR
IMSLLECLALMLRVLLL	LE CAM
CRETAT	CRETAT
ATAPDVWLULUU	PATARD
TOH	TOM
MNJFWMR	RANJAKUMAR
COUTELBIFP	COUTELLIER
AWLVLFFLLZVORVELNVZVVAJL	FIORENZA
MMSNMLELTUUERJRVIJCJJRU	LETERRICR
WVIN	KEVIN
AMY	AMY
HORR	HORR
BAXIJIC	BATISTA
NFFLSLAL	MARISCAL
HSSANCHLEZL	SANCHEZ
YERTILE	YERTILE
NMSWLLIWI	OBADI
FMACQUEURYILLYLLL	FACQUEUR
CORBIISIER	CORBISIER
DELDIICWE	DELDICQUE
AWLAIN	ALAIN
DSWMI	DESFONDS
MMSTRCALVLAVMLYELVRLN	CALAMEL
HELANIC	MELANIE
DOSSANTOS	DOS SANTOS
DERUDDER	DERUDDER
YOUCEF	YOUCEF
TANBUY	TANGUY
EHPUA	EMMA
WLWFWNWALINW	LIGORI
BAPHAEL	RAPHAEL
DELACHAUX	DE LACHAUX
PERISOLS	PERIGOIS
ALSSDUD	AISSOUB
PSALENA	ALENA
LWA	LOLA
PILSHHIATHHNIHSHALNMIIM	MATHIS
MMLTPNLLEVUSUUILNVU	PLESCY
QLEXIS	ALEXIS
WSTHONAS	THOMAS
HALLUS	MALLIS
WSCARLA	CARLA
IWLLOLNLNLAILLNTVJJYOVJJ	DONNAINT
MIATIHLLDEIH	MATHILDE
ALWIWLLRE	AMBRE
NLLOLAS	NICOLAS
MLILSILNILAC	MIGINIAC
PIETY	PIETRI
JUPLIAN	JULIAN
CANILLE	CAMILLE
ANNA	ANNA
SLMON	SIMON
CAGNON	CAGNON
LWWLIOLYTFIM	HIPPOLYTE
EMMA	EMMA
WMSPWNAIYHLYVVDJJR	VAHI
MMJTRPOLSVQLUJVQELRDTJ	PASQUIER
JPAILLET	JAILLET
MMJTCWCLHYLLLUBUVYFYFCLHLWNT	SCHIERYBACHIMONT
DVBOLS	DUBOIS
MAFTLN	MARTIN
LOUISE	LOUISE
H	LENA
WPAUDLIERE	PAUDIERE
IMSLRAFFLRLAYVVLL	RAFFRAY
WWFRUMWW	FRED
WENAI	EMMA
MMSTRIOLVUTIJANLDIIVL	LOUTAND
LAURYUE	LAURYNE
GLLLANT	GILLANT
CHPISTOPHER	CHISTOPHER
LLPEA	LEA
DELORME	DELORME
NLOEHLE	NOEMIE
LMLNERRE	PIERRE
JOSEPH	JOSEPH
CLPLARA	CLARA
PSSOSHUA	JOSHUA
LPSINLELSI	INES
ELEA	ELEA
MHWUONOWIW	HUGO
MWWOLEANUJNXLL	PADIOLEAU
PSSAIAB	SARAH
EMHH	EMMA
IMMLTPRLLVWUEWVNJ	PLUMECOQ
DDKLNE	DORINE
WAWDRNLWENHM	ADRIEN
LUCAS	LUCAS
PSJFRENY	JEREMY
CFPHEULLLE	ORPHEVILLE
ANLMLEN	ANNWEN
EWDWISEVILLVLVC	EDWIGE
WLULS	LOUIS
PLLVEIS	VEIS
IIXHVANNWHOPWILW	IVANMOE
HLLL	ALI
FFRNCT	PERROT
YXAURA	LAURA
LYSWILWLL	WION
SULJEN	JULIEN
JWSLFFLPHLFLPELILL	FARGEPE
YPLAM	PIARD
LUCAS	LUCAS
JMSLPLVOTLLIVYLV	PIAT
JWMLTDRWLVRLLUHLLLILL	DUTRUGE
WSALLCLLA	ALICIA
WSWPTILSLFLJ	BAPTISTE
THOXAS	THOMAS
FLLVMAN	EVAN
AFFILF	AFFILE
GUYOT	GUYOT
SPLNON	SIMON
ESLPERABEIVIBNAU	ESPERABE VIGNAU
MISOSUE	SOSUE
LEA	LEA
WSFLEUR	FLEUR
DOUASBIN	DOUASBIN
LWMSRMSOIULJILJLROLNIJL	BOUILLON
RCLLEPI	ROLLERI
NMSLBELSSLVANULYL	BESSA
JWULES	JULES
WLAURENCJVLVLLILV	LAURENGOT
PSLVLTLELVLLLLL	VITEL
HELIMA	MELINDA
MPSTKMLIVICTAIYUJLN	KISSAY
LMPSE	ROSE
MMSVMPFITULLTOIUFOOULYVFNTLNL	PETIT-SOIENTINI
MMLRNLLLJLWJEIWLWVV	DUVET
MMSVMFOIUVQLUVEVTGIEAYNU	FOUQUETEAU
UWTIM	TUSTINE
YROWAYROL	ROUCAYROLL
ARCHLR	ARCHER
AHXJLS	ALEXIS
ELLA	ELLA
CWIEMENTLLLLLLLL	CLEMENT
LMIRCCES	ROCES
IWSGROULSLSEAU	GROUSSEAU
JWEDILOLNLLLLL	DION
LYCGANLITO	GANITO
HLMXIIW	DBAXIME
PORRLHEALI	PORRI MERLI
MSANLSSA	ANISSA
MH	ADAM
GWULLLAUHEAU	GUILLAUMEAU
HLANON	MANON
POUIVET	POUIVET
MMSPGMLIRVLWJNNFUBAUON	GIRARDEAU
ALBANE	ALABNE
VWRRECLLR	TORREC
LWEWNLLLLL	LE JEAN
DOUARIN	DOUARIN
VVLY	JOLY
LOVLSIWNLNLQUC	LOUIS-DOMINIQUE
SWLWSLLLLNVLL	SIMOES
PABLO	PABLO
WUOLLE	NICOLLE
LLWMCRARILVSSJJANOUUTLIOD	AISSAOUI
MATHLFU	MATHIEU
TICANNE	JEANNE
ANNUS	ARTHUS
AARTIIN	MARTIN
WSEYE	SEYE
MLWSLWLLILLLL	NASARRE
CMPHALPLINYRJAUDZJVLEOLWL	CHAPIN-JAZUEL
PLOCW	PIOCHE
CHRISTON	CHRISTON
NATUAW	NATHAN
WLDLLALL	RILAL
CONSTAWIN	CONSTANTIN
MSLFUVRNOLYNLAVLV	FURDYNA
AWHCHDI	RACHDI
MMLMMRBSHUOYNUUFYJBELL	CANONNE
DUNARCHAT	DUMARCHAT
PLCLFMENCE	CLEMENCE
LUCLE	LUCIE
JEWWA	JENNA
BEHJANIN	BENJAMIN
MWUUHRWAIW	LAURA
THEO	THEO
BAAUD	BRAUD
ROUEMONT	ROGEMONT
MLTYUEO	MATHEO
INE	INES
UURA	LAURA
WSNAYANA	MAYANA
MATHLIEU	MATHIEU
NYOLRET	NOIRET
LNMSLLAIYSINVTEY	LAISNE
HELES	KALES
RHRISTLIANIIBOTLIN	CHRISTIAN - BOTTIN
HHTHIS	MATHIS
ZMMELLIILEUTTAVRLLLLLUU	BELFETTAR
PSANTOLWE	ANTOINE
MMBMHWIASNW	MATHIAS
JEAEMY	JEREMY
JMSAWLLNFYL	ACHAMLANE
PIMBGAUH	MARGAUX
CCFAVE	OCEANE
ZOZLIN	ROBIN
JWOUYLLLLLIL	JOUY
MBOUMUN	BOUKOUM
MSJEAXNLL	JEANNE
AWBZESKFEWLILCLZ	QRZESKIEWICZ
WVWHLBEWNTLNWL	VALENTIN
SAUZAY	SAOZAY
HGDVIITHLFRNW	GAUTHIER
JOCHUA	JOSHUA
FBSLEH	FASIEN
ADELE	ADELE
WSJONATHXN	JONATHAN
EILSLLC	ELOIS
HWWARASWORLEW	MARJIRIE
MABTLLCL	MABILLE
TIHONAS	THOMAS
WSTHOMAS	THOMAS
GGOLR	IGOR
FLODANCE	FLORANCE
LIWINSJFLLFLLL	INES
LQLOU	LILOU
MWSYICWAABID	MOUTAABID
WE	MAXIME
LVITLLEL	LUCILLE
KILYAN	KILYAN
SLLOWPHLS	SOPHIE
MSWLS	NILLS
BWAEDEYL	BARBEY
EUYRIELLE	EURIELLE
LELLCLE	FELICIE
CLMHARLOTTE	CHARLOTTE
RWALADLERVJVVLJLI	BALADIER
MRROD	PARROD
LLZLFLALEQOUZVIILOOLUVVWLP	LE GUILLOU
LELAY	LEA
THIRIEQ	THIRLED
PSBARBLEJEJLITELLLLI	BARBEDETTE
MSLOUIANN	LOU ANN
MMSMFMWIVNYYUTDYL	EWEN
JJFAS	JOSIAS
LPLLLLLCAYRWVLFERL	GARNIER
LLMMSMMFLLURLNLLHAJJOL	FERRAT
TMWARNLWBHW	MARIA
DECALONNC	DE CALONNE
WMMMMWMW	HOAD
WLLTLCUL	LILOU
DMSVLIENNAUMALL	VIEAU
TWO	THEO
BOYFR	BOYER
YSALBLIZLULNL	ALBIZZATI
RJLZVFLLJ	RYNINE
LWINEINF	MELINE
PLASSMTI	PLASSART
JWIHULIIIEWTTHEIH	JULIETTE
MRLA	KARLA
WSSELIN	GOSSELIN
MLIHE	HELINE
MKLLLCLLLEAYCFLLLIYLLJ	DE CLERCQ
LWLBLSTLELUF	BISTEUR
PLLLSE	LISE
WPREVOSTVLLLJILI	PREVOST
MMSMHMOIVUTLJVYFLYUYV	HOHINAL
HNEVA	MAEVA
LPSALULLFHIJDI	AUFFRET
WIALHLS	ALEXIS
ROSLIN	ROBIN
TLIJANL	TIJANI
AKMOUH	AKMOUM
MWLEANWIW	LEA
IWLLLTTLLPAVBLUICLJLLY	TRABUC
FJIV	PENIN
JVNLLALDLLCR	QUINTAVALLE
LYLLEROUXL	LEROUX
LWSSEVAN	SEVAN
OUSLTFLNNDT	OUSTELANDT
BEWEDICTE	BENEDICTE
WWADAMMWOW	ADAM
WSFYFUAVL	ESTEBAN
BLARRIDS	BARRIOS
LAURA	LAURA
MPAAULICRE	MARZELIERE
NZJILIHLIDDJ	MFFAMDOJ
JPAHE	JAMET
MMSRFMLIIURJAJRCDJONN	GIRARD
IJFAEHY	JERENT
SWMCOLLVEMVJDNULIN	SCOLE
JLPVLLIE	JULIE
MLLSTLLLREYYLOISVTVUVI	PREYOST
XU	XU
LWSMHELYJ	MAELYS
HELOLSF	HELOISE
MEGHIT	MEGHIT
LVPLNCENT	VINCENT
LWOTHVLLLLVLL	LOTH
AC	TAO
LSWCBAYIEN	SEBASTIEN
WSORLANE	ORLANE
LMWUCNAWSIW	LUCAS
SMEAETLLL	SERET
APUSTRVY	AUSTRUY
PSLLFAIILLIIWLI	LEA
LLWSIMOULLILIICIJLI	MOULIC
MSAYKUT	AYKUT
WJJULIE	JULIE
LPLHLUOOL	HUGO
IMS	INES
WEMEN	QUENTIN
LWWASLLMLLLVL	LOUASIL
WWJNEAUYILLLL	BRUNEAU
WLJAX	JADE
YDRECI	DRICI
SCARIOY	SCARIOT
WSMIKKAELA	MIKKAELA
AXEL	AXEL
WSLDEVLWYILLJVEWL	DELOZIERE
IMWRIWNWANM	IRINA
DSEYWLLEILML	EYQUEM
PLNTOMSSDNTOS	PINTODOSSANTOS
PBEOVSSLZE	BEAUSSIRE
MARCHAND	MARCHAND
FWAUGERAS	FAUGERAS
MAELLF	MAELLE
RWOJALL	ROSA
NOAH	NOAH
MAWDRNIWENHM	ADRIEN
WMUDLN	GAUDIN
FLWIDHJIMFIHLLL	FAHIM
LPEVASTOIS	LEVASTOIS
WSDLIVIER	OLIVIER
MYICHEL	MICHEL
NLWELODY	MELODY
WWAOU	AHADEI
MMSRMFUILLLLTJJLJBU	COLLET
MTULES	JULES
LYSNIUUIUUFWIIU	AUDOUARD
CHYALPLWTE	CHARLOTTE
CLENENT	CLEMENT
AWWLEWXWISAW	ALEXIS
ASWBRIELXHSHLIREL	GABRIELLASHNEL
DESRUMAUXI	DESRUMAUX
PXEII	AXEL
DEAUDRLER	BEAUDRIER
NUIJIAMNNW	BENJAMIN
DCCTATLV	PORTATIU
GOURION	GOURDON
JWMSVGMELFYFIRIOLVYLVL	GEFFROY
LOCATI	LOCATI
MMSYNNALDLAYLVVVM	NADAL
HATHSLDE	MATHILDE
SWZERLIE	SUTZERLINE
WWILLEDELLSLBLULTLTLELS	GUILLE DES BUTTES
WMSMBMEISVSTAOLJEYUHOL	BESSAICH
BOTROUX	BOIROUX
MCSFWF	SIBRI
MPSTRRELGLYNVEEIVRICLL	REGNIER
PLCHLOE	CHLOE
VALENTENE	VALENTINE
AXFLL	AXEL
WSNATBEN	MATHEO
WFOLLEMFALNVLYVLL	FOLLENFANT
AIEXANDRE	ALEXANDRE
WMWRMIWANNW	DORIAN
LMMSTCVBLLLLLLLIALTJLIN	CAILLAT
PIMNWAS	MATTHIAS
JBNTA	JABATTA
WPEYHAUDVJLLYLI	REYNAUD
ALAN	ALAN
WWLAYLLLILLLL	BOUAFIA
DWEEPLKA	DEEPIKA
LBUPIINE	LAURINE
PZTHIBAULT	THIBAULT
WSMAXIMC	MAXIME
RWLLELLJYASYSEVYYWYLV	REISASSE
TARTIVEL	TARTIVEL
MWLOMMIWNW	TOM
NATEO	MATEO
PMEIUERLIYYVYV	PEIFFER
ASPASIE	ASPASIE
FYOUCONNIEQ	FAUCONNIER
WSEDZO	ENZO
BJVXHNHE	BAPTISTE
MMLPGNALPVPIYLNVVLIJN	GAPPINI
WSNYANA	RAYANA
LLEROVX	LAROUX
PSRONAN	RONAN
LAWA	LAURA
CWMAFVFVFLARILJJVOJBL	CAFAFA
EWWOENNWHW	EDEN
JWLW	DUCLOS
LNILWON	FILLION
JLLILE	JULIE
LEO	LEO
LWWOUMIWSENW	LOUISE
CWVWR	GOUVREUR
PLISJCLLEJMOENNTNNNNMLIW	CLEMENT
WSBELDLTLTFL	BELOTTI
LW	LOU
PSVAYTHA	MARTHA
LERAY	LERAY
HATKO	MATEO
DWIEW	EON
NLWAOLT	MINAULT
PSCLEMEWE	CLEMENCE
MATHLLUE	MATHILOE
IMMCTMRALTVLOVVVLICVVLL	MATOVIC
FIISENWLILOJAHIDAMINM	ENZO
WSCHARLINE	CHARLINE
PIEWE	PIERRE
LLULIISVJIOCITNOJARNLWICP	VICTOR
WYUZCNS	POUZENS
HSWLBIOU	ABBOU
AWSCOUETTEL	COUETTE
DMLRIFFET	RIFFET
DANKOL	DANKOI
BENJAND	BENJAMIN
PSHAWON	HANON
QUATIIN	QUENTIN
PSHOE	NOE
HMWAWWNW	TEA
MNVEL	RAVEL
WMLSSADFWLLLLL	OUISSADEN
LEWUCHER	LE BOUCHER
LMMITVTOLNVHVFJTVLLLL	TONNET
PSDIIFKLHELIEINNWWL	PIERRE EMMANUEL
HNVVT	MAEVA
MWENNHAWHW	EMMA
WSAXFL	AYEL
CWMHWQULMENOULSOJLJJJX	CROQUENOIS
SOLPFHIE	SOPHIE
KWLPINLDLELRLSTUNTHTLDVW	KINDERSTUTH
JLEREHY	JEREMY
LEA	LEA
BILAL	BILAL
MPARAIS	MARAIS
MENIRI	MENIRI
LJWIULJILELNELLLL	JULIETTE
FRZETMAN	FRIETMAN
MNASSL	FANTASSI
WWMIMWSEIW	CORLIE
MSWRLUVVLLLLL	BURKE
WSLWLA	LALLA
JEANNE	JEANNE
WWLEDMNWW	LEON
GALLJNE	GALLONE
LHAVINES	CHAHINES
CCNOCUMY	CONDOUMY
GRAOLL	GRABLI
BEPTAANDICUBLINO	BERTRAND - RUBINO
CHLVEZ	CALVEZ
WSNOA	NOA
WSJEAN	JEAN
CHADLLS	CHAPUIS
AWBUHLSLLLLL	ABECASSIS
BERGOUGNANIRLSSEL	BERGOUGNAN-RISSEL
WIANAFLLE	ANAELLE
WLEMFLE	EMILE
BARTH	BARTH
UFEZ	LOPEZ
WILOURANNE	LOU-ANNE
PSLENA	LENA
KERJEAW	KERJEAN
WROUXEL	ROUXEL
LUCTORL	GORTARI
FOURLPN	FOUEIEN
MMA	EMMA
WSLDEIIGAMW	DEL GAMBA
LPIILTATLHAWLDHNEAEANMILM	TIMOTHEE
DWSLEHARLE	LEMARIE
AUSTRVY	AUSTRUY
WSLPAULTLHLGIEYRUY	PAUTHPER
PPELEW	PELINI
ANTOFNF	ANTOINE
SLIMI	SLIMI
PACOI	PACO
CLMLETENT	CLEMENT
BARTLSTE	BARTISTE
JWWYLWEWSNM	JULES
PINOEHIE	NOEMIE
IWSMAIQUALILRE	MAQUAIRE
MMSRDWOLVUICEJTHJLVL	DOUCET
JMWULMIWENNW	JULIEN
HDYWHRJ	HAYWARD
GRENLER	GRENIER
MSERWN	ERWAN
WLCOANVEL	CORNVEL
LYSIPIELTILTLL	PETIT
ALYCILA	ALYCIA
HLARLIDAN	LARIDAN
MMLPRWOIUVQIULEHVLL	ROUQUE
NIEL	NIEL
KLEIN	KLEIN
FUYILT	ROSSET
LLQWSFWEWLLCZYK	EWENCZYK
PSHARIE	MARIE
WSYANIS	YANIS
PSUW	CHERAZADE
PIALFLAAJHJIIIHIW	LEA
HSFERBECKLLL	FERBECK
IIXHHANRWLDTEIW	CHARLOTTE
FMSOLLVLELIRA	OLIVEIRA
AHRIARLIENW	CORALIE
IMMSTRHALRVULTLYVUVNJYLLAN	HARUTYUNYAN
LWSMATHIIS	MATHIS
WWIMLFIVAOJYJIJIV	LEAU
WWFVAL	OLIVA
LOLC	LOIC
LPLGLAHLBLFBLL	CAMIPPE
YIISHIALPNFSNAAIMWIM	MATIS
IWMABMAAMTUJJLWW	CABARET
WL	INES
SOPHLL	SOPHIE
LARYRC	LAPEYRE
MAELYS	MAELYS
PLIBLAWLLLWILEL	BAPTISTE
HASSON	HASSON
PWLARDVYVVULW	PLARD
SACU	SACH
AUDLNELLE	AUDINELLE
BOURDW	BOURDON
COAWINES	COROMINES
PSLUXAS	LUKAS
LEOFOLD	LEOPOLD
PSFABRET	FARRET
OWHONT	OMONT
AWNMEVIUVLVN	ANDRE
MMSTMVALZVOTIYTELRLLL	MAZOYER
HALFLELB	MALELA
PEREZ	PEREZ
WSDRALLPLEAU	DRAPEAU
ALEXAADEE	ALEXANDRE
ULLACK	BOLLACK
HAMELLLN	HAMELIN
SWLINIICLLY	SINIC
HWSLCLLINLTVELLLLLLI	CINTE
AUBRLU	AUBRIOT
AWENG	REMI
MWLUCNIWEIW	LUCIE
FWRWAU	ERWAN
CLARA	CLARA
WSKILLIAW	KILLIAN
LINDA	LINDA
YWSANFNL	BESANCON
LRWLAPJHLAELLLL	RAPHAEL
ELYSE	EKYSE
MLETZ	METZ
MLPWINE	MARINE
HANW	JOANNA
HWSLLEBVNAUYLNLLVIL	LEBRUN
MMACHENAUD	MACHENAUD
NMBDTLHWEONW	MATHEO
GRAGLIA	GRAGLIA
NPENNESSON	MENNESSON
LPSALEXANDRE	ALEXANDRE
ETILJE	EMILIEN
MTWOSNCWHHEIH	TOSCAME
LAUIILHE	LAUILHE
LWMSRPANLVDJREIJNDU	ANDRE
YARINF	MARINE
WSYANQSL	YANIS
MLSTALLUGVALGLNNVEULRIV	AUGAGNEUR
GUENFE	GUENEE
PSLDULFANIDIPVRLLOJST	DURAND-PROUST
WSWFRA	KEIRA
PSFWAN	EWAN
OMSBHRIOIUIILLILON	BROUILLON
LLMUSNAZLOILYJLOTLOUWSWNM	H
HRSFBLLELLFYBJBYILLLLR	BELARBI
CLLGNA	CIGNA
WWUWWOCW	ROMEO
MLWOUNNWAHM	LOUNA
PCLCLAIRLF	CLAIRE
LEVALSIS	LE VALLOIS
WLPAUL	PAUL
JASON	JASON
LWFSWLLOLELPHIRLLNVOLVIL	MOEHRING
JWWULNIWENW	JULIE
LAWULGNEG	LASGUIGNES
ELOUAV	ELOVAN
WWWMWUNW	MORGAN
NATHIS	MATHIS
SPALLNA	SALIMA
LPSPACAHE	PACOME
YSCASTAGNE	CASTAGNE
PSBILLALIILL	BILAL
GLLLW	GILLET
ASCAMLLLE	CAMILLE
GWLLALLALSSFOLVVVYIII	GALASSO
PSNIATHIANLLLLIJ	NATHAN
LWOULSFELLLLLL	LOUISE
PJAGATHE	AGATHE
MMSRHMELVMIEVRYLVJVV	HEMERY
WSROMAIN	ROMAIN
MARIN	MARIN
LUCZKOW	LUCZKOW
WILLLW	LILOU
TWCHE	ROCHET
AWMRYLYLLYLLL	AUBRY
LBPPNJAHIH	BENJAMIN
IMSCHERYLLLE	CHERY
ALIZEE	ALIZEE
NMLLFEPLVMELAVULXYLL	FERMEAUX
LBRBDVM	MARHOUM
YATE	YATE
LMHAGNONLLLL	CHAGNON
JWWJLXI	JOZWICKI
ALEXIS	ALEXIS
WMWFMNWTINNW	QUENTIN
WIVALENTLNE	VALENTINE
AMWUWNWLHM	AUDE
NEPOTU	NEPOTU
AWLLEBOELF	LEBOEUF
BOUFETTOVSSE	BOUFETOUSSE
WLW	MAELLE
DRMNGE	DOTTANGE
HWERVIER	HERVIER
HRDLC	TARDIE
DWWPSHEWHW	LISE
LUMZDUBRULLE	DUBRULE
WMIMHMEIUSTJAJEBAJVYVR	MESTREAU
PSTLNWN	TITOUAN
WSFXHI	EMMA
WSLILLALL	LILOU
NARIANNE	MARIANNE
NMSVANWNINRHW	VANDEN TORREN
ELLLSA	ELISA
WSENLIO	ENZO
NWUWASL	NICOLAS
LALINE	LAINE
SARAH	SARAH
PIIILUIALREOWTINICWLEAWIIM	VALENTINE
SEGURA	SEGURA
WIDIERRLIC	PIERRIE
PSFTHDN	ETHAN
IWLLECUPLLPVKYL	LECUPPRE
YDEMUYWK	DEMUYNCK
LPIAHY	AMY
CORUICR	CORMIER
FLEXANDRE	ALEXANDRE
QUENTIN	QUENTIN
MWLMNMIIIRULYOYUNHOYYU	OYYOEDDB
BAILLEUL	BAILLEUL
FORESTIER	FORESTIER
FSBERNLARDLL	BERNARD
NMBONRWANW	FLORA
NLWELOW	MELODIE
GTERHK	GIERAK
LPIW	THOMAS
LATRW	LAFARGUE
LUDLVLNE	LUDIVINE
HMHLIAAL	HAIDARA
AUGFR	AUGER
CMAGNIARDLL	CAGNIARD
MTLPPELVRJDJRVLLAVULLL	PERDRIAU
GARNIER	GARNIER
AMELIE	AMELIE
MAXINE	MAXIME
DEMAY	DEMAY
HWRUCHOT	TROUCHOT
BELATTRE	BELATTRE
PSHWLALLJLU	MAIA
BNOCUV	BROCHU
PRENOT	PRENOT
PSFONTAINE	FONTAINE
IILEFEYRE	LEFEVRE
AWWDENSWHU	ADEM
MAWHMNWSHW	ANAIS
DRLDEL	BRIDEL
LIWSOUBLTALHMRADLL	OUBAHMAD
BGNV	BINTA
POLZERBVFS	POUZERGUES
WWANTLLLLLVLL	MENANT
LYLOU	LYLOU
MXLLSNAWIW	LISA
YUANN	YEANN
TWWKNEWLLLRLLLL	TURKMEN
ALRTLNUFLH	ARTHUR
AXE	AXEL
AMHNUNVILVLVLV	ASSOMREA
TSLAVSE	LAVIE
PWIDMHIFUTOLTLUUYJJNL	DHEILLY
WRWAPMHWAELAM	RAPHAEL
LISA	LISA
WWHLIERVL	GOHIER
SEYEW	SEYEN
ASCIA	ASSIA
LPSTOLML	TOM
EWVCHLYYLYLEYVLLVVLLI	ECHILLEY
PSLIEIOIIHILL	LEO
WTLLWF	BUILLAUME
ANATA	AMAIA
WILLWNE	GUILLAUNE
CLHMLOE	CHLOE
NMSSAHLILVZLLVUVLL	SAHLI
FAES	ENES
PLLBOLURRIALGLUEL	BOURRIAGUE
ALMLIZEE	ALIZEE
PSWESILLLJ	INES
AUM	ALANY
HFSSEAU	BOISSEAU
EWNZO	ENZO
VIRUSHATN	VIRUSHAIN
MMSTDLLELVIYTYRFVGLJOYVEVN	DE-YRIGOYEN
KMREBSYVLLLLIL	KREBS
MMMWISOYSYSOBR	BLANK
WSLEO	LEO
LMMSYCMRIUINYRJUUZOIJLOIJHV	GRENOUILLEAU
CAUIGNAVX	CAVIGNAUX
CLLYA	CILYA
UEANE	OCEANE
WNET	BINET
LWSTULFS	TULES
GAIULLHILLEF	GAUTHIER
FASTLE	BASILE
MWLOHNMWNM	LOHAN
RODRLGUFZ	RODRIGUEZ
VMIAL	VIAL
WHHMOSTEFAWILL	BELMOSTEFAQUI
LYDIA	LYDIA
BWMFHMAMIUBVCWILGJV	BENTALEB
WSPVENTIV	QUENTIN
NARLNE	NAINE
CWALLLE	CORALIE
MJPAUTPHTI	PAUTRAT
TANDLDN	TANDIAN
AWUBOLNL	AUBOIN
PLMLELI	NAEL
ELITGAS	PETITGAS
YLOWA	YLONA
WSCLALIQE	CLAIRE
LOANNE	LOANNE
MWSMMROIUWRHYUVJUE	BOURG
WIALAN	ALAN
BLOND	BLOND
OUCUABO	OUCHABO
GIAETAN	GAETAN
PLCHM	CLARA
WAUNANN	STRAUMANN
PABLO	PABLO
LWLCDNTIV	SANJIV
DORIAN	DORIAN
MSHATEC	MATEO
AUGLAWS	AUGLANS
NATHAN	NATHAN
NAYA	MAYA
JEANNE	JEANNE
LEJEUNE	LE JEUNE
JSIVLEUILNPW	VELAIN
PSHELLHAAIUIHILHMIW	ELWAN
GAUTRALT	GAUTRALT
MWWLMGWANW	JULIA
LPLBERLNARD	BERNARD
WAFOUFOU	AFOUF FOU
MWUIEPVTYY	NOGUIER
PSARTHUR	ARTHUR
IWITHELPLALULTLLLL	THEPAUT
NWSPIFPOU	PIEROU
GWLFABLGLIYAVJVVUIJV	GAGGIA
LEH	LEA
LFSPEMOLNLSAW	PEMONSANT
JULES	JULES
PSMARSAUX	MARGAUX
GRANSON	GRANSON
LMMSPMJUIVIWFFTICJIVR	DUPREZ
LALIE	LALIE
YANBIS	YANIS
CLEYFNT	CLEMENT
HATHTEU	MATHIEU
MMSMMSPIVUHJRLXYJJN	SPOHR
CAWRALF	CAPORALE
PIWGILU	QUANG-LU
RYBENSXI	RYBINSKI
SINHA	NOAH
LANGLWLIRLEFOY	LANGLET -- LEROY
SMANGAREL	SANGARE
HATHLLDL	MATHILDE
IWSLCACCLARVELLLLII	CACCAVELLI
SAMONDADAZ	SERMONDADAZ
WWMUVTUMFEVMLVVYLVN	BOUTURE ADRTEN
VWIHNNNYWNAHW	VANYNA
TALSWLER	TASQUIER
CHEVIIILAUD	CHEVILLARD
MSLEO	LEO
DEGENLLLE	DE GENTILE
PSLAPORTEI	LAPORTE
WZAOUNL	GHEAOUNI
WHWNE	APOUTTANNE
HILBERI	HILBERT
WSJLJLLHI	JULES
LEFCVRE	LE FEURE
CWWLANRWFSHNW	CLARISSE
AXELLE	AXELLE
LMMLTMCHIVIRTOTLDJOIL	CHIROL
AUGUSTD	AUGUSTO
MWLANNAWIW	LANA
HLENOE	MENDES
MJFLORA	FLORA
WLDARLC	MARIE
PWLALN	POULAIN
STANISLAS	STANISLAS
PLALIXL	ALIX
RAPHAEL	RAPHAEL
JLMEHANE	JEHANE
IOANA	IOANA
WSCYXLL	CYRIL
MWLOUNIWSHW	LOUIS
WSNATHAN	NATHAN
SDHLHLZ	SANCHEZ
RONNNDY	RENAULT
NOLETNLF	NOEMIE
LWWOLMCWW	LOIC
ERNESTILNE	ERNESTINE
MILGVLPLPLAVMLELL	GUILLAUME
PSWWAIUXI	MARGAUX
GWWUFNLWHLAUMEHM	GUILLAUME
AHEL	AHEL
NAXLIHF	MAXIME
EHLOE	CHLOE
LMLAUYHFIUVLWVYEVRU	AUNEONIER
MMSYNFOLYRTLIJUNVVLV	FORTIN
NMWASNWLMHM	NASSIM
WMEZIIERE	MEZIERE
BEVAAD	BENARD
HMOUSNFLFRVVLVLYIL	MOUSNIER
DDORLLAU	DORIAN
SOSEPHLNG	JOSEPHINE
MMSPMLOILPVILNUTIUOUU	LO PINTO
PSNOENIE	NOEMIE
PILOLA	LOLA
DUPUN	DURUPT
TERNACLE	TERNACLE
MMLRMPLLYDELTUVVUL	AIDET
PSJKTNULR	ARTHUR
BWRNNFLL	BRMNEL
PAUL	PAUL
MMCLFLATALRLDLLIL	FLATARD
WLAVRETVLVLLILI	LAURET
MSMARIE	MARIE
IWYHMNAWINWIW	ROMAIN
WMWBNIOWNHM	MARION
CLEMSNT	CLAMENT
MSFNZO	ENZO
HSLLETLEVLLLLIEELYRL	LETELLIER
GFAVLER	GRAVIER
LWSLZALRRLOVILSLLVL	BARROIS
WCHATHIS	MATHIS
PLLSIWIRALNICHEHLIWIW	GARANCE
CALRCAGNOLO	CARCAGNOLO
MAZOYER	MAZOYER
MWHUCINOWNW	HUGO
HOW	HAWA
GWIGLEUXLYVLLLLL	GIGLEUX
DUYLERLLRF	DUTERTRE
VANGHELLUW	VANGQELUWE
AHBAF	AMBRE
POPTER	PORTER
WSMATHIS	MATHIS
WMWWMWLINW	MAGALI
LPSJEREMY	JEREMY
PSLEWLS	LENAIG
BMAILLIEUXLLLL	BAILLIEUX
MSHJLSCH	BASTIEN
MWANHNWSAM	ANAYS
COUWT	COUROT
LEO	LEO
PUIXEL	POIREL
TIJREAN	DORIAN
MSBALLLLLACULV	BAHLAOUI
ANSLADC	ANGLADE
LDEA	LOEA
MXIWLIEU	MAXIMILIEN
COLLLELATTF	COLLEATTE
LFGRHND	LEGRAND
MSUNENZC	LORENZO
ANAELLE	ANAELLE
NEBWD	THEBAUD
MMSPWPEIVDFUYCAUJRTLUN	PERICART
MWWRLVLMIYLL	ALBERT
VIFHLHLC	CAMILLE
WISEPH	JOSEPH
PLTROULLLARD	TROUILLARD
PJLAUREN	LAUREN
WWLFKLLWLYVLJIJJIJ	DUPOOY
LWWUCNAWSAM	LUCAS
HLARFLNE	MARINE
PIJYLANL	DYLAN
JJHJIL	JUHEL
HSBIBCLHELIEP	BACHELIER
MSOWNA	ONANA
GUENARD	GUENARO
LWJELLH	ELISE
FICNA	FIONA
BCHLILOEIM	CHLOE
LWSCLEMEHT	CLEMENT
WMLPGMWLVHUYWJTZ	GUTH
BATILLAT	BATILLAT
OLLLORO	DLORD
DUHAUTCLLLY	DO HAUT CILLY
MMSRMANLVCELNVAVYLVYUI	ANCENAY
IWLAGOFLRNOLYLLL	AGOFROY
LLPLIJIALLEXIIIFLLINWIUW	ALEXIS
LYLOU	LYLOU
MMLPGRALVRTNLJVERLVLL	GARNIER
NMSLAAOTHEL	LAMOTHE
MEDJAHDI	MEDJAHDI
EOARFAL	CORBEAU
WSJBPAHFM	IBRAHIM
WMTOURL	DELTOUR
IWILSAILLNLDLRLEVLNALNLL	SAINDRENAN
WVFAYLL	VIREY
WJALVESL	ALVES
MMLHIAS	MATHIAS
JANIERIDUBAY	JANIER-DUBRY
OSWRL	OSCAR
FORNES	FORNES
NWHXINE	MAXIME
MLLESTLLYRFCIULLILLL	ESTREGUIL
WSFVANL	EVAN
YDNLS	YANIS
DJIUJ	DJIMY
QYIAN	DYLAN
WIAWMA	ANNA
LAGENTIL	LAGENTIL
WWKT	POYET
WHELIMSWFDW	ELISE
TON	TOM
DARON	DARON
JYLFIA	JULIA
KLOFLP	KOPP
GLMDAHXC	CLAIRE
MIKEYRWAN	KEYRWAN
CPCLAS	COLAS
AMLS	ANAIS
LUNA	LONA
ALWNTOINE	ANTOINE
WSNFRFHEN	NERIHEN
DEGHLZATN	DE GAZZAIN
YWLFANN	YANN
LPSECLVEFILDRULHI	BRUEP - - DRULHE
LILC	LILI
JWZWYLLLLLJL	ARBEZ
DHAWLULELAHM	MANUELA
WLGIRELGLORV	GREGORY
OWWPHWEWLLENW	OPHELIE
WYWASWAWSUEIM	YASMINE
MSLCALRFANLTAINLL	CARFANTAN
NWZSUBLAS	SUBIAS
HOPEY	MOREY
ELEONOR	ELEONOR
WSRAFAEL	RAFAEL
LISA	LISA
MARWEN	MARWEN
PSANTHONY	ANTHONY
PLCIHAAILHOTTE	CHARLOTTE
LMSWYVLVELVVIMI	BAYLE
HARTIW	MARTIN
PZFLORPNE	FLORINE
WMSPWMIRYCVTHALNJDUOLUL	MARCHANDOU
IMSLSOUBLALBLYERLLE	SOUBABERE
BOURACHCT	BOURACHOT
EWOISLAINOYLLLLL	GUISLAIN
PSWBLNIF	GABIN
PSWWVAW	DONOVAN
WCOUMELL	COUMEL
LPLSGUILLLAUMIENWIW	GUILLAUME
DEMASFNAND	DE MASFRAND
WSPAUL	PAUL
PSNATHAN	NATHAN
NHWOONWIM	NOA
WLINES	INES
FDAXCOLIS	FRANCOIS
LPSVLILCTIORLIWW	VICTOR
LLNOU	LOU
GMWULWLWHEMAW	GUILHEM
CONLSTANCF	CONSTANCE
WWEWZNOWIW	ENZO
EMEL	EMEL
WRW	BAROTTO
ALLIWNDRF	ALEXANDRE
HSLVANVVDLELHVOYSLSELAER	VAN DE HOSSELAER
CDRIH	CERINE
ALLSTAIR	ALISTAIR
FLEURV	FLEURV
MSTON	TOM
JFDOLLIDUFOUF	JADOT - DUFOUR
WLPRAT	PRAT
WVLD	DAVID
LWALLELXFHSHLH	ALEXIS
WIUFHWQ	HEATHER
GIBHANH	GIROMANAY
LERLA	LETLA
HEDOCH	HEDOCH
NAFLI	MAROL
WLRFBLOTL	RABIOT
TARRLEU	TARRIEU
HLUILULLHLANI	GIULIANI
NARCHADD	MARCHAND
MSMARJUS	MARIUS
ERNEST	ERNEST
LWMSYBVOLYUVSLQUVLCTLYY	BOUSQUET
WLUCEVLLLLL	LUCE
HOROAWE	MORGANE
MATTEO	MATTEO
HALSSONE	MAISSAME
ELUACHIXSV	ELBACHIRI
VWALHOAAUILLLLL	VLHORGUE
GAELLE	GAELLE
WMSMRMEJUBNOAJGCDJULNOT	BERNAGAUN
NARTINEHU	MARTINEAU
MWWTMHWEOW	MATHEO
HWESSAOUDVLLILLLLL	MESSAOUDI
AWMDIUUPLLL	AMDNEAU
OUXRLD	OUKRID
MSROMANE	ROMANE
MMLMLMDILUJROJILXJUUV	LACROIX
PILLEVNTYEOYULALLNLEC	LE NEOUANIC
MMLCLOURDON	GOURDON
EDBFRP	EDGARP
LWANDAISLLILLLL	LANDAIS
HELVYN	MELVYN
MMLPVNELRVNVHJLETLDGL	VERNHET
WSJEANIBAPTLSTF	JEAN-BAPTISTE
PIILVLAILIEANIHLNIOAWINM	VALENTIN
LMLYSLYBLLONYNLUVVUVUVU	BONNEAU
LOPES	LOPES
WJYCAMNWNFW	JEANNE
PSHIARGEI	MARIE
NALH	NALAN
WLOU	LOU
HOULAYUIPXAUI	BOULAY GIRMAUD
GLLUMKLE	BUKIE
MEHAYA	MEHAYA
JWSBLLANC	BLANC
JULLLE	JULIE
MSLPLLLCYOYUVVELYLL	PICQUE
MMWAEMLWLENM	MAELLE
MMCMBMAIDVDFJNLLLJJL	BADIN
CHLOEI	CHLOE
VWJSTOLLLLYELYRLLL	STOLLER
HPSMNALRLTFYIVLLLL	MARTY
RWULV	SAULE
WSCAROLINE	CAROLINE
VNIS	IANIS
WMCMMLFIRULUCSUORTBBM	LECIERG
CWELIA	CELIA
IKWHANNLUOWIM	KANTO
EHMA	EMMA
LPIXUI	XU
IWSLHADLLLOLNELLLV	HADIONE
RUPPIN	RUPPIN
PADILOLFAU	PADIOLEAU
VLWERENA	VERENA
PSLORIS	LORIS
WCSUBERBLE	SUBERBIE
ABITUL	ABITBOL
FIGUERAJ	FIGUERAS
HWUUENUAWELIW	GUENAEL
VMRMW	CORMON
MANOH	MANON
WUANU	GONBAN
W	YAO
BMWLENMWHCEHM	GLEMENCE
LWILPANE	LEANE
MLVSFMLLENYJWIYRLUVV	MENAGER
YWWONMNWAMJ	YANN
PSTHEOII	THEO
IMSBOULRGESLLL	BOURGES
MWIOMSIGUYFYSYLIWWN	OSSEYI-DOH
CLOB	CLOE
WBAPTIISTE	BAPTISTE
NLATHLSSLL	MATHIS
ETHAN	ETHAN
WBOWLERD	BOUVERET
GALOPIN	GALOPIN
MWSRWMIWVVUIEHRJYUL	BOUVIER
CWBLOMTWZCRENW	CLOTILDE
HMSLMORLOLWIIAINLLY	MORDOGAN
NMELLLNLMLALVLAFLALJIHN	NEIL NIMALARAJ
WCMLENMWENCEHW	CLEMENCE
PWLLOWLWFIVUILUJVN	POVEDA
HELANLIE	MELANIE
JWWEAMNWNEW	JEANNE
MICECILIA	CECILIA
WSDORLLAN	DORIAN
ALLLLALRE	ALLILAIRE
HCMWMMRAH	MOHAMMEDAKRAM
PLILLVOLIIONLVETOWTENMLIW	VIOLETTE
PSWATHAN	NATHAN
WALCZAH	WALCZAK
NLINA	MINET
WMWWNBUEIW	OCEANE
WSLUCAS	LUCAS
WWCJJMIWJNW	LOUIS
LWRLTGLLELWLVRLNEAVUVLUI	GENDREAU
LUULSE	LOUISE
MSRANIA	RANIA
LUDLVLNE	LUDIVINE
ZIYAD	ZIYAD
WSHELRLFI	HELOISE
DYOMILNGUEZ	DOMINGUEZ
PSCHDQUFT	CHOQUET
ORIANE	ORLANE
VCNS	VONS
NWEHAULTLVYVVILL	MEHAULT
JLWANE	JANE
GBETIE	GBETIE
ETLPAFZ	TIPREZ
QUEMQN	QUEMIN
WBARBIER	BARBIER
LAMSGAVHLHLVIELUVLL	GAUTHIER
HLUGO	HUGO
LEBLOHD	LE BLOND
LISON	LISON
LWSJATOIO	JAMOIS
LWAHDUROWVLNVYLLU	LAMOUROUX
ENN	EDEN
BWERBNVDVLLVILV	GERBAUD
PIISNNARKNNJNNNRLMMINM	MARTIN
LWWOLMAWAM	LOLA
YPAW	YANIS
WWLWMWEOW	IRATXE
GWLLUFLEZELSLLLANALLL	GIMENEZESPANA
WSLFU	LEO
ALWLHAJILSLLL	AKAIS
ALVIAS	AVIAS
PFRAF	BARBE
SWWNHA	SHOWWA
PSMHJARATLLINNHULWH	MARTIN
WBRISSETLLLTL	BRISSET
JWSLLAMLBLYERTLL	LAMBERT
WHRIL	BAHRI
NLWY	THEO
DELNJSUS	DELASSUS
PSELISA	ELISA
GARRLIGUES	GARRIGUES
MWSMVMTIBUNJYOLLYTIL	VIGNOI
BYARTHEL	BARTHEL
FWFIJJLLLLLRILV	APOUTOU
WLWFSMEWW	LISE
ANK	ANNE
GIABAIEL	GABRIEL
LFWNE	LEMOINE
GWARNIIEALLLLV	GARNIER
LPSLUCIE	LUCIE
IALVIN	CALVIN
SOGNO	SOGNO
ELISA	ELISA
LPSMOLELZLL	MOLEZ
DELLHERMITE	DE L'HERMTE
EWFTEWV	ESTEBAN
PSLUCACL	LUCAS
LUPLYSJ	ULYSSE
IWLLFOLUSLLFLRDVNLIL	FOUGERON
MOUFIN	MOUGIN
AHMEDIYHSSINE	AHMED-YASSINE
MSMAXIME	MAXIME
MLDUCFE	LUCIE
FLOJLNF	FLOREMR
MAZZOLEWL	MAZZOLENI
LAKHLLFLL	LAKHLIFI
INES	INES
WLMATHIEU	MATHIEU
PMSRRBRLUVNGIVJJJL	BRUN
AMBRE	AMBRE
HPECJR	HECTOR
PIEPRX	PIERRE
LLWMSTMHAIUVGTEYTVVGJL	MAUGET
NWSLTAXLILNVLELYLL	TANANE
VALEHTLWE	VALENTINE
WAOUZ	BEDNAOUI
WBASTIENVL	SAATIEN
AAPTLLIJTE	BAPTISTE
BINUU	BINTOU
PLCCHENNOUFL	CHENNOUFI
MMSMMPOIVTNLTLFLATLYYI	POINTEAU
VMANHOVE	VANHOVE
PALLNNIER	PANNIER
MONWLONI	MONDOLONI
LWELAVW	LEANNE
BOUKRL	BOUKRI
WGJYFWU	NGYEN
HDURLRANDE	DURRANDE
LAWUOLIITIN	AUGUSTIN
DEDUVLLLE	BEAUVILLE
MTINFRLVIRCHLOLTJVIVU	FRICHOT
FHHA	EMMA
MEMND	BREMOND
KSCW	KSON
TELXEINA	TEIXEIRA
PMBOUTOT	RABOUTOT
ULBLEUSE	BLEUSE
MLUVSJLARYDFNVSLTYIIDU	DESJARDINS
MMSMMCHIUAYBJTUIYERIIJNLL	CHARTIER
FWAURE	FAURE
MMSMMMFINROYOIUUJMIZASS	MERAOMTA
BPLABH	BLAMM
SARAU	SARAH
MAHJNI	MANON
FOURNLER	FOURNIER
PWUCFUX	BOUCAUX
FIRWN	FIRMIN
VALENCE	VALENCE
DAHUX	BAROUX
DOUSSIN	DOUSSIN
HOTMJ	HOMMET
NAYA	MAYA
PSDYLAN	DYLAN
REYNAUD	REYNAUD
WIWHUWWIRWEIW	GREGOIRE
VMNCLER	VANNIER
DRACGCA	DA CASTA
WWFFYLLLLLLLL	BOFFY
GWLFOULDDLYVNVVVL	GOUDJIL
LPSBENHAYOUZ	BENAZZOUZ
YANONL	MANON
WRNANLS	BARKATI
PIJOEY	JOEY
GLULLLLERMIN	GUILLERMIN
VALENTLN	VALENTIN
LPSSARA	SARA
LLOLSCOL	HOUSSOY
BPOUXHRISSS	BOUKHRISSI
PLISNIALLULHILNRLNNMIIM	NADHIR
BOURDET	BOURDET
MWARIIN	MARTIN
PLMYA	MYA
ELPLISA	ELISA
BWLTOMASLLINLLL	TOMASIN
PIFXXE	PIERRE
WIAHPOILWLINHEIH	APOLLINE
CYPAEEW	CYPRIEN
ZLWLOELL	ZOE
ULRARD	GIRARD
FMXLWNWLENW	FLAVIE
MXJLLNEWSIW	JULES
BOUDARD	BOUDARD
HUGO	HUGO
GOURVES	GOURVES
WSCAULTLFD	GAUTIER
HARAFS	MARAIS
STAFIISILLAS	STANISLAS
YLSWIILWLLHLA	BENBACHA
PSFLIORZLW	FLORINE
GAUWRT	GAUBERT
LLILOU	LILOU
YFSIMLILVIL	YASMINE
WWLEMNWANW	LEINA
ADJLLM	ADELINE
EW	EVA
ANAELLE	ANAELLE
LUMSCALLLGADLS	CALLIGARIS
PSTHEO	THEO
WLRFLBLELSFYVVIIUILJ	RIBES
DWSLOURIDELLE	LOURDELLE
WLILYHNE	ILYANE
QABBAL	QABBAL
SANDAA	SANDRA
POLLWUILW	POIDEVIN
MSLLDLEYIWALRVRLYELWV	DE WARREN
MLTOSULN	TOSCAN
IWVWLANXFEIYLLH	VIANNEY
WLFVD	EVA
PSDHIINIAIILIIHLW	DINA
CHBLHW	CHBINOU
LPSELIXANE	ELIXANE
LWSLOU	LOU
SAFRANA	SAFRANA
AATHUR	ARTHUR
LPLSDATRYLSIIILIJ	MATHYS
BFDTNLI	BALINI
EZSA	ELISA
PLATTIER	PLATTIER
DMLWE	AMINE
WMASTNRWIDNW	ASTRID
LWFILERC	LECLERC
CLEMENTINE	CLEMENTINE
WSRONANE	ROMANE
JVANNLS	JUANNIS
MLPAUNLIEBL	PAUMIEB
PLZHUI	EXELG
LENA	LENA
MAAFE	MARIE
LMHULSSILU	LHUISSIER
MCWYRNIWZLLXNM	CYRIELLE
WSBENJAMIN	BENJAMIN
DMNLLLLLLLL	ISTI
MAGWTIER	MAGNIER
CMWTEWULLLVL	CATTENOY
MSTONLNALULRLLL	TONNAU
MLATTEO	MATTEO
ALLAW	ALLAN
LWWWI	MOHAMED AMINE
CMLENENT	CLEMENT
WSLOULS	LOUIS
WWLLULL	BELLEC
PSLDULSE	LOUISE
WY	ORY
WMSMVMDIULLTJNNUU	VALLET
FTWO	ETHAN
LFYHIIVIZR	LAMALLE
ILHAN	ILHAN
MSLGUTLLLVI	GUTU
BWSJWLHWLLCRF	GOUTORBE
MMLMPMOSUUPYIYTUOMJYUQ	POUPINOT
PSAURIOIRIEI	AURORE
ALICE	ALICE
LEFEVRE	LEFEVRE
SAWH	SARAH
FWELIX	FELIX
ASHFAQ	ASHFAQ
LLSON	LISON
IMWWWSWIW	INES
ENFLEE	EMILIE
AUZAWNFT	AUZANNET
VLEL	VIEL
LWSLLORLCLYLLLLYY	CORCY
WUWLMAWNW	LOLA
PLDOSSNVFCSF	DOS SANTOS
PLADRIEN	ADRIEN
NMSLMICHALLLALK	MICHALAK
WKLLLLW	KILLIAN
IWSCORNILLEL	CORNILLE
DILLL	JONZO
IMLLLSLFLHLVILLVLLL	RIRELLI
GODARLI	GODART
SMUMRWELLE	SUBERBIELLE
LWIN	LEMAIRE
TLLHWOHAS	THOMAS
AXPELLE	AXELLE
URNN	LEPRON
PSPATRULL	PATRU
MWSMMDDJUIOIYCADNJUSPI	PRESSON
LOUANE	LOUANE
LEVA	LENNA
LEA	LEA
DWUPOUTL	DUPONT
MMLPERILYSLENDXCHOTUEJVVRI	EISENCHTERER
YATWEU	MATHIEU
EHHA	EMMA
RENAULD	RENAULD
AAPHAEL	RAPHAEL
PSSANCEIRNE	SANCERNE
WLJULFFN	JULIEN
THUAERL	THUBERT
WASYNIU	NASSIM
DLPTNITRJ	DIMITRI
WSNOA	NOA
LILIUC	KAVINE
RAYET	RAYET
WSPOTLYTEYFLLLL	POTTER
BERLAND	GERLAND
MMWLLL	PONS
DWLUE	DUGUE
IMBERT	IMBERT
PLISVILICITADRNLLIAINMIW	VICTORIA
GZANNESSNLI	GIANNESINI
LALLLUA	LAURA
AURY	AURY
LPSSABRILNA	SABRINA
LEFEVXC	LEFEURE
OWILEIBOULRHJI	LEBOURHIS
WRES	SOARES
HLLMOVWIALNYWLVLNV	MONTANDON
OWESCHAHPLLLLLL	DESCHAMP
MLLQLKSAIALLJ	QUESADA
BLENOLT	BENOIT
PLELISENE	ELISENE
CHLOE	CHLOE
PIHALRGLAVIXLIWLS	MARGAUX
SHLRLWE	SHIRINE
CWHAALONE	CHARLOTTE
MO	THEO
LENA	LENA
PSALICIA	ALICIA
MMSMMPDIUULJYYJNLYD	PAULY
RAKOTO	RAKOTO
WSHAELYS	MAELYS
WSHDTTEO	MATTEO
HAHWLLWN	MAXIMILLIAN
EDOUARD	EDOUARD
PSFFPELL	APPEL
MMLFWLLEFLYAWVMU	ARANEGA
HWATUIEUVLLVVLVI	MATTHIEU
PSLCUP	LOUP
LWSZVVISIILFLVFH	D
PILDEJESVS	DE JESUS
BCHWJL	BERHAIL
PS	H
FUALWLS	FAULDES
GAAWT	GARDET
LMLLELROLFUXFYLLLUVVVV	LEROUX
MRAWRNULRLNLLF	TAVERNIER
LEANNL	LEANNE
BYAD	RYAD
WMSMMNIZVBZBRTLYILX	TAZIBTE
MAXWCE	MAXENCE
LPLILTIIFIELNNIILNMNM	TIFENN
MRDUBNEWWIW	RUBEN
YVES	YVES
DIFL	DIEL
KALLIYA	KALLISTA
WLWOUMLWSAW	LOUIS
MVSTBFOYELRYLLLLL	BOYER
LEANE	LEANE
SAOF	JADE
JLLFHAND	ALLEMAND
HWET	HEQUET
DEODAAH	DEBORAH
MSFARAH	FARAH
CHARLES	CHARLES
LYSOLLLLEIR	OLLIER
WWLHRWUJCODURGOISSGS	CHARGE
JCSELPHINE	JOSEPHINE
JACOB	JACOB
CAM	CANDE
TOUBLAV	TOUBLAN
WURANT	COURANT
LWFONLLTL	LEON
WSNJHFDEJLFIYLL	MOHAMED-API
LOUISE	LOUISE
YSALINE	ALINE
WLHOUMWW	LOU
WSSAMS	DOSSANTOS
WUM	SALOME
SHLREL	SHIREL
WSHARIIESARAH	MARIE SARAH
RLAHEH	RAHEM
MLLLLFNLLASVIYLUVVRLYLL	NASSUR
WSIALLALLFRL	DALLALI
NMWEYMLWANM	NEYLA
HLWIELLIAFLLILL	HELIA
KOT	KOT
WWWMNHWOW	JEANNE
WSTLDVLA	CRONOS
LOCFJ	LOGET
KYLIA	KYLIA
JICBFSAICH	SEBASTIEN
WCHUGO	HUGO
SOUXAYND	SOUKAYNA
CORNELIA	CORNELIA
ALEXANDRE	ALEXANDRE
PSXIILLLLLANL	KILLIAN
LYLLBOT	LIBOT
MDHANEI	MOHAMED
CAAUX	CAMON
WLLLLFSMILVVARPFALIJHGABVLHVTHAM	SIVAPTMAVIRVTMAYA
WUWAMRWAAWI	CLARA
BRUEZQFRE	BRUEZIERE
PETIT	PETIT
NELLSGA	MELISSA
LANGLOLS	LANGLOIS
CALCANO	GALFANO
MMSMMPAIPLFYAJNLLJOUU	PAREAN
WFAUIHYYHLLL	RAUCH
EHELINE	EMELINE
SACHA	SACHA
PBENELOPE	PENELOPE
LMAFAYLL	LAFAY
WNMMMHIWLBW	MATHILDE
CESCUT	CESCUT
JZRBNEVVYLLLYL	JEROME
LAWLDEJLHELLL	ADELE
WSALYSSA	ALYSSA
WSLUCY	LUCY
EHYA	EMMA
NLPIUK	NRIZEK
LPOLBILWX	CORBILUON
IHMHANNOUNWIU	MANON
PLLILBOUYLSSVELLKELYLL	BOUSSEKEY
IWSALLKELBVILJLYL	ALKEBI
MARZE	MARIE
GRATFOT	GRATIOT
PSCHLW	CHLOE
REGAD	REGAD
MJHLCZ	JACOB
MUAGF	LESAGE
WKELVFY	KELVI
ANNLNF	ANTOINE
PEPRLU	PERRIU
PIISHRIAYLAHNIIIILLIWLS	RAYAN
VPINCENT	VINCENT
WLTOM	TOM
LWEFUVRE	LE FEUVRE
DERTLN	BERTIN
PSMTHFO	MATHEO
GHLSLALN	GHISLAIN
WILHRVNIMAWIH	LIVIA
WSJADE	JADE
JULIE	JULIE
NWLDUPELRREY	DUPERRET
LMLLLSTBLLESVEVHVEVRLVJN	BESCHER
YSRINUUINJ	RINUCCINI
ADELE	ADELE
LNMSNAIQRY	RALARY
LEVOUX	LEVOUX
HAHTLOU	HAMMOU
MMSMMMDIUOTUTYNLJUJJ	MARTIN
WSLRLLICLHIALRYDTLIL	RICHARD
MMSRMHALVRJZETULJUU	MARIE
MSALEXANDRE	ALEXANDRE
PLLLILEAAIILIIWW	LEA
HLALDDAD	HADDAD
WZLALFOLRETL	LAFORET
HSIWHAULFONT	BEAUFORT
PSNIAGO	TIAGO
IFANNEAU	JEANNEAU
AHBRE	AMBRE
LPSDAFBRLOONI	DJEBROUNI
NPKRANDC	FERRANDO
MSLLLEVVLLINLLLLL	LIEVIN
NLPAELLIIS	MAELLIS
MMLPFMOLUYRNRVAVGLIEVN	FOURRAGE
CLAIRE	CLAIRE
MWACHRUVVLVVNLL	MACARCZ
IWILFIGUELIREDLOL	FIGUEIREDO
TMIMADYVVLLN	TIRAND
WWERTSONLLLLL	ROBERTSON
WMJPMALIEVXVIAWVDVLYYEW	ALEXANDRE
PPILAFCTYK	PILARCZYK
BWAUWTLLIILNEDUNUULLI	BAUDAT--MERY
PSNOAL	NOA
LMPJCMHIUAUJVHTIVNIIHDONQBZCTS	CHAUVIN-DOQQIOTS
LMMIMQMUIVLVVFJJVLJW	QUIVET
WZELOISE	ELOISE
CHATLMWN	CATHERINE
BOLCSOH	BOISSON
ROMERC	ROMERO
PSIDOJL	IDOI
MALLHLEU	MATHIEU
YHNLIS	YANIS
RAIAEL	RAFAEL
NLLMNHAN	NATHAN
IMBEM	IMBERT
MSLFRAYNVTVZLYVLLJ	FRANTZ
HANON	HANON
LEA	LEA
ZAHNIT	ZAHNIT
WSNALENFLIN	VALENTINE
PSLEA	LEA
WLTILCRLNHL	JUSTINE
MMLTPLLOLTTLLVELVLIVRNV	POITTEVIM
WSYATTLS	MATTIS
VANDENBWUCKF	VANDENBROUCKE
RAGNEAU	RAGNEAU
OLSENDEKPAY	OSENSE KPAY
WMSMMLAIUFDFSJFUFLORWJAWC	LOPES EFRWAWDES
MSALESSANDW	ALESSANDRA
HASTLEH	BASTIEN
WWIMNMTJCLYCGNLLTDFYU	UNREADABLE
PIISSLOIUNXULLBLLIINMIIM	SOUMIB
BHPLLSTH	BAPTISTA
NATHAN	NATHAN
WWXLILLLLLI	FIOUX
VWANOENABCELEL	VANDENABEELE
CWOROCERYVLLLLLL	CORDIER
WLHAYILLRLYALLML	MAILLARD
LLMEA	LEA
EMMA	EMMA
MMSTIVDLIVLALVLYIT	IBIL
WWLLLINLLLLLVLL	BALLIN
PSEWL	ENZO
WMSYVVALVWNDARLYJJJ	VANNA
MOWU	MOREAU
VENNEIL	VERMEIL
LEFEVEREI	LEFEVERE
MWNDIWL	GANDIN
LMLFRALNLDLLLLL	GRAND
NWWMNWNW	TOM
MJOUVENT	JOUVENT
ROFIIQUE	ROFIQUE
EMMNMOYLMUJYMIYH	FENDY
LAURM	LAURENT
PSMAXIME	MAXIME
LMSHASSQNOW	MASSINON
MSHWLH	MATHILDE
WSHERHANLE	HERMANCE
WPFFAUMW	DE PREAUMONT
CAO	CAO
HARBAUX	MARGAUX
LAUEINE	LAURINE
CMHENU	CHENU
MENLEC	MENIER
WWDLENRWREHW	PIERRE
NOINEAU	MOINEAU
LELAF	LEA
MSPLAWCHE	PLANCAE
MSLBERVRLLAHLYALL	BERRAMA
PSPFERRZCKL	PIERRICK
JDDALEEIIDUFALLLH	PONTIER-BURTIN
WSBCNNTL	BENOZT
PSGULLLOUNE	GUILLAUNE
THAI	THAI
BLIOYJ	BINORD
AHANDLNE	AMANDINE
NHPH	JOSEPH
WLPADLO	PAOLO
CLARA	CLARA
AWRLILLMEYHIWVNLLVLIWV	ALI MEHENNI
COLINE	COLINE
LWTLRLALLVHLAIYTLVHU	CACHAT
JMSLLEYGRLALWLDLVLV	LEGRAND
DANGHN	DANGHO
SOUHILA	SOUHILA
MINATHIS	MATHIS
JLSDFES	DESPRES
SIMON	SIMON
TOSELLO	TOSELLO
WMN	PAMART
SERENA	SERENA
EWWLFNSWAHM	ELISA
MZABUNTL	ZABENT
PSRJXVFLIILLRII	TCHA
SON	SADE
PSELISA	ELISA
CONSTANCE	CONSTANCE
WCOLIHL	COLIN
MAZOTTI	MAZOTTI
HALEIVA	MAEVA
TWMOLWRTMOULUOUBLUYUJU	TOURTOULOU
ASADRIEN	ADRIEN
CWHAPMAN	CHAPMAN
MYSTRKILHLBELRJWVJVL	KIMBERGT
LPSAIMILNIATNIALNIHLI	AMINATA
PSILIAUIRIRYAIIILHF	LAURRY
BWENNUVVVLVVVL	BENNAI
RAFFLEGEAU	RAFFLEGEAU
MMSTLRLLYBULJHVANLLOOL	LLBIHAN
DKTERHE	DETERME
WSANM	ARTHUS
LAWINULNJILNELLI	AMANDINE
KEVLN	KEVIN
POCLET	POCLET
PCILMCTNC	TIMOTHE
MMSPZMIIIVOJUDNPULILUN	ZITOUNI
PSITZLARI	ITEIAR
TRISTDN	TRISTAN
MSHWWW	JOSEPHINE
LWYSFLHLADVVTJRVDN	HADIR
CIRARD	GIRARD
WBESTIONLLLL	BESTION
PSGAONI	SIMON
DOSSAWW	DOS SANTOS
MMSMCMEINVDYWYVNLUUD	GENDRON
PLLAURA	LAURA
MORET	MORET
MFWE	FRANCE
MFLILLLL	MELVIN
SANUEL	SAMUEL
PSHAPINE	MARINE
MHTHUS	MATHUS
VYOCANSON	VOCANSON
MWSERNGWLAAW	SERGIA
MMJMDWUIBVUMCYBUY	DUBUC
MMSMMTLIITUJJYUILLSVBYY	TITOUAN
LDMYLAN	DYLAN
WLLAUQAJ	LAURA
PWILLIASVVLYVYLV	PILLIAS
PMLIEYON	DICHON
IWSLDELGRLMLLLLLL	DEGRET
FHAN	PHAN
AMBRE	AMBRE
MFPTIN	MARTIN
WTWIAOWTHEFNW	TIMOTHEE
DWESUHPSVJINYVV	DESCAHPS
EMHAVVET	CHAUVET
SCKIUW	SCHILLER
BAPTISTE	BAPTISTE
LDSELESE	ELISE
SINOWNEAU	SIMONNEAU
OASSSET	BROSSET
FSNOZAYEI	NDIAYE
WSFHRHH	SARAH
WRLSSAYLLYLLI	RISSAY
NWLLLOAVAYSLYLLLL	LORAS
PSMEZLANOTTLL	MEZZANOTTI
WMW	BOUTBOUL
MATHIS	MATHIS
BOSNJAXCVIC	BOSNJAKOVIC
MALOMUUNYLLVV	ALONZEAU
JOOF	JADE
HUW	HUGO
HZZLI	ZAZZLI
WMWMWNW	JOAS
MLJAW	JAOE
PLSOLINE	SOLINE
WIPERRIWEL	PERRINE
BLIEVIN	LIEVIN
XAELI	MAEL
WZQUENTLN	QUENTIN
SANTOS	SANTOS
NLEHY	JOEMY
DJATLN	MARTIN
EMWVANNWHW	EVAN
AMLJPARNAKIAN	ALTIPARMAKIAN
AIJPCULYN	JOCELYN
LMMSPPNCLVHJOKILSIYHVLLVR	POKORSKI
TOM	TOM
SFAA	SAFAA
MRLFVXLLLVLALJDILIVVJL	MILADI
DWZLLALVLLLILIL	DELAL
CALSYSANDRA	CASSANDRA
WLBMX	SAFAA
MWP	MAE
WSLUCTF	LUCIE
IWLLRLLEYMLYVVLYLI	REMY
JVLLANNE	JULIANNE
DARRILKURORK	DARRIEUTORE
FATRJLK	PATRICK
YIIO	THEO
WMJPUWLVLAJNLIULEUUL	EAVANIE
ARNAUD	ARNAUD
ZWDBELIHVILLLLLVI	ZIEBELIN
TLNCALT	TINGALT
MRAMONF	MIRAMONT
ISMLAEL	ISMAEL
ABDBIILAHL	ABDELLAHI
PWLETLILLLLYL	PLET
MBOHE	nan
ELYLEH	EYLEM
LAISNE	LAISNE
OXFAFY	ONFRAV
MWSRMSEINVHJALNUOUVLVL	BENHAMOU
MMSMQMUIFVNTUTHLJLJJ	QUENUM
LPSCOTTARD	COTTARD
MAXLNLLLEN	MAXIMILIEN
LEPNHA	ENNA
LPLANWE	AMBRE
LWSALEXIS	ALEXIS
LLFHYA	LINA
IMSLDULWLILSYYLLI	DUBOIS
PIHAXFLNLIEILLU	MAXENCE
MMSPLMAIYCLJCTVFOJJL	LACOSTE
AMMWVLYLEUJUOOON	ADJALLE
IMSLDUMOLLULILNLL	DUMOULIN
LEAOGEROH	LEROGEROU
UWURLLLLL	BOUR
UAYN	KAYA
ELWN	ELWIN
MRSFLLLCBYOLVURILGILR	LEBOURS
FLLNLOPRYNA	FLORYNA
IWMEAWNNLMUVOUYJDR	JEANNES
CLEMENT	CLEMENT
WSNSKIJA	NIKITA
PIISLLRARAILGNANNLNWIIW	LARISA
WTAJOUR	OUTASOUR
DMORENLEUX	DOREMIEUX
WFSTENFR	HOFFSTETTER
MIENZO	ENZO
WMSMMSIIYHNLLLLIYTJJN	SCHMITT
WSLROALPLTVEVALUVXHL	ROMPTEAUX
FRDNYLLS	FRANCOIS
HAWN	MANON
ANGIBAW	ANGIBAUD
WNSLAM	BEN SLAMA
MFRIOTTF	HARIOTTI
MIWHARNIOWNWWIH	MARION
MWELODY	MELODY
CASSAWDQF	CASSANDRE
IWLLLLSFDLLUJVAVIRJDFRNILL	DUJARDIN
CIWHAPUUUCIWNLELIJ	CAPUCINE
RJU	RIOU
DIFLLOVA	FIONA
ANTOHIC	ANTONIO
CWWWENNWNIENOPNAW	QWENN-ENORA
FMHEILLWNN	THEILMANN
DECRW	DECRON
MLSTESSY	STESSA
MAEVA	MAEVA
BOZES	GOMES
LPSNOLELMILIEIILLHH	NOEMIE
OLEANE	OCEANE
MSSKALILANI	SKALILAMI
YAXENCE	MAXENCE
WSFLLW	ELISA
LLEBIUHUT	LE BIGAUT
BMSPMMAIVUYFUJVUIUL	MADRU
WICLEMENT	CLEMENT
WJWUSNTWINEHM	JUSTINE
NAUHY	MAURY
RWOCHELVLLLL	ROCHE
YWVSSEAULVLLLILI	MUSSEAU
WSHOUFAD	MOURAD
WSPAUL	PAUL
ALLAN	ALLAN
LMMSYMPOIYTNWEAJJYL	POTTIE
WSMATTHIEU	MATTHIEU
XAYNHK	KAYNAK
ROMEO	ROMEO
LWRAQH	LORRAIN
LFSA	LISA
TWUSHOFRALSLVLYVLN	TRASHORRAS
COSCAS	COSCAS
YSZOEILLNMIW	ZOE
LUKH	LUKA
WLCELESTLLNJ	CELESTIN
AMLLFCNBARLBEYLL	ALLION BARBEY
PSETLEHDE	ETIENNE
WZMAELLA	MAELLA
WLERIHF	ERINE
PSALATBJBD	MATRID
NHIER	JAHIER
AWLLMIJNELL	AMINE
PSILVANILLHJ	IVAN
LLPSNAOYLLLWLW	NAOMI
WWSVXMRWULAXW	SUKRULAN
CLARA	CLARA
CHARLY	CHARLY
MELISSANORE	MELISSANORE
BWEN	AWEN
MTSVMFLVJIIDLIIVHR	MEJIA
WE	NOE
NALFOY	MALFOY
VWALLFCMINENM	VALENTINE
MMVFULLVLLLLL	ROUTIER
WMLMMLRSOCYFDOTSOOFIUUHRRN	nan
PSALLEXAWDRELHJ	ALEXANDRE
MLPHO	MATEO
WWSFONTALNES	DESFONTAINES
PSAZEMLA	AZEMA
PSLUICAS	LUCAS
DCRA	DORA
BEZIE	BEZIE
HPERLORIX	PERDRIX
BEWFT	BENOIT
IHWHALILLSWIH	MAILYS
WAW	COUTANT
TWTMLALWFVILUYVJ	TALAMON
CMWHANRWLVTENW	CHARLOTTE
MWLWLFCVKNYVIVL	VANDERBECK
GOYON	GOYON
WUWSEMVWUNW	YSEULT
DLUARTELEITE	DUARTE LEITE
MUBEWAWMNW	OCEANE
LLWSRUMAIN	ROMAIN
LEPEVDEVBN	LE PENDEVEN
LWSLAUMOWT	CAUMONT
THLBAUD	THIBAUD
LLMUM	LUNA
TAMBOLSF	TAMBOISE
MSCRALYLLJ	GRAY
WTWOSHCWAHEHM	TOSCANE
WILWLIS	LOUIS
MWDIANNWANW	DIANA
PSFARAH	FARAH
JEANNE	JEANNE
WOLXWLLLLLLLL	DIABY
BENJFMLN	BENJAMIN
MMSPJMFLAVNUCDOMUHQNTN	JEANCOURI
THONNS	THOMAS
NULLES	MULLER
JWWUMNWIVLIUFHWW	JEAN - VINCENT
HSCAQON	CARON
WSEHY	EMY
WBWS	DUBOIS
SERAPHQN	SERAPHIN
NATIEO	MATTEO
GRAVLLLON	GRAVILLOW
COUGMNDLE	COUSTENOBLE
MLHAL	KIHAL
NOAH	NOAH
WSERUW	ERWAN
WWFUMIWXW	FELIX
LPSANDERSON	ANDERSON
DELESU	DE IESU
LLLOU	LILOU
SWARMFALOE	GARRAIALDE
INSRLD	INGRID
HLATLHISLLI	MATHIS
LPLCELESTE	CELESTE
JWLIFILJLL	DESBUSS
PCJFNBLAUD	JAMBAUD
DSU	LIA
YEVLOLEVTLW	REVCOLEVSCHI
RCUOEAU	ROUDEAU
PSMOHAMYED	MOHAMMED
MSDICNORUH	BENORAB
AMELLE	AMELIE
GEQRGET	GEQRGET
ANGE	ANGE
DWOZSEVJJVLVUU	DOISE
WYSYFNOLRYTIFUNYIVL	FORTIN
MIYBAW	THIBAUT
UBO	UGO
ABORALL	ABGRALL
THEO	THEO
LVI	LUC
SWSQVELEIWIHEC	QUELENNEC
MSHOHBIAZFITLLHIIIII	MOMBAZET
MIILILLILILAL	DAUQUIER
HAERAT	HARRAT
LMSLANA	LABA
DSHARY	MARY
AGATHE	AGATHE
LWMLMMPDIOUIJHSIINYOYA	POUCHIN
AWOVXLLLLLL	ROUX
FMWHNLLWEAM	FABIEN
ISDHBEIPEGOHA	ISOMBE-PEGOMA
HRLYNORJ	HEYNARD
NDAH	NOAH
FLRHANIDEVR	EL RHANDOUR
IMSLRFBWHLLLLIVLLVL	REBHI
SANAE	SANAE
MSACXLS	BENIS
MAW	MARVYN
PFRWHE	PERRINE
AWG	ADAM
YASVIUE	YASMINE
MMCPMIVUILUFAJUVCOUHVLLLE	FAUCHILLE
JWACAHOALVVLLLVV	JACAMON
WMLRDMAIVLIGVUUVEVNLORUTNE	DAIGUEMORTE
MSVICTORLA	VICTORIA
JULEIS	JULES
ACLIFARES	ALI - FARES
MLWARNAWIW	LARA
UA	EVA
WSFLWFAN	FLORIAN
MAXUF	MAXENCE
WALLCLLILLLI	BOLLEU
GINLES	GINIES
AUVERT	AUVERT
CLBIHALXLLFYLLLLL	CHARLY
ALULAN	HUAN
ERUUARI	EDOUARD
LPSCIAATHARLNIHNAAIIWW	CATALINA
WSAMBRE	AMMRE
MWSABMAWHNW	SABAH
LMHCUNKWAHW	LOUKA
LHSLFAVLRIILLL	FAVRE
IMJWALVLLAVRTLRLL	WALLART
FANDOS	FANDOS
NOLANL	NOLAN
HENRY	HENRY
IWSLJALNZLLALCLLL	JEANZAC
ZNFLPL	EMILIE
MVIOLOLLLLLLL	VIOLO
BONVAFOUX	BONNAFOUX
W	TRAOBE
LDLUNBIDFHNVTFUR	LALUNG- DE HAUTEUR
PSMQNELE	MANELE
MIEICSALAILL	MESSAOUD
BEHVVUS	BEAUVOIS
PZARWELNLILJ	ARWEN
WPGOULELLLLLL	PIGOULE
BHAABARII	BARBARIN
WRSFGLLALLLLLILFVETLLI	GALLIFET
MELANE	MELANE
WKFJXIINLNL	KESKIN
NAWFI	NAJAFI
WMSVELLVLRYAYRIDLVLLLL	EVRARD
JMACQUARDVILLVIL	JACQUARD
DELAPORTE	DELAPORTE
MWUHAMMED	MUHAMMED
MSMRIWH	DURANAD
PALARD	PALARD
MSPERKINF	PERRINE
LHLSENIOANIII	SENON
DCNATIEN	DONATIEN
MSTANGUY	TANGUY
WMLMWMSLULULUJNJLUIULGVL	BOURAMI
PSMELLQA	MELINA
VLHAH	JOLHAN
LWSKRUG	KRUG
ASNOELTE	NOELIE
NWMARVLLELMUJXVUJJL	MARIE
WWIUWDDSLONBYHLNJOLWLMDV	BAKJOBRIGMA
MMCYPMIICVHDJATUJOLV	PICHAT
TILLLD	ANNA
TOUNKL	TOURK
JDSEPHLAK	JOSEPHIAK
MMSRMHOILVYZALLVLVV	MOLZA
SEVIN	SEVIN
LORENZO	LORENZO
PIILIHMIISHIIIINWIW	INES
WMJTNBOIVNUNELTVVVLL	BONNET
BPIAHD	BRIARD
WSMATTFOL	MATTEO
MVXFCNTWORNW	VICTOR
LGWILLLJLLLAILL	GILIA
HWADJLLLLLRL	HADJI
WPUTUIER	WAUTHIER
ATBRE	AMBRE
LLFBAX	LIEBART
MPLPROLZYILEIVRIJCUHVAVBEPTL	ROZIER-CHABERT
MSNORA	NORA
ABRELA	AGRELA
CMWCENAWHEHM	OCEANE
EFNAN	ERWAN
NOVSSH	MOUSSA
TAZLI	TAZI
MSLDUCLPLWUVXLJVL	DUCREUX
TUUMMA	TUAMMA
LIGOAVFC	LE GOAVEC
CUGUFN	CUGUEN
WSLOVLSIWLNLWF	LOUIS DOMINIQUE
NAALLOUNE	DAALIOUNE
HELOLSF	HELOISE
PLIISNNJLLNYDUDNNIUWLOW	NELSON
RWLCHANDYVLVULVL	RICHARD
PSLZILIIII	nan
MMSMGMIRUMYNLCUYPDTYYI	ETCHEBERRY
MAMATN	MARMAIN
IWMSPTVALRYDUUVLLLVL	TARDU
LPLYLFLFLAVRTLLL	FART
WLLLSFDLLELVOVLVLVYLELLRLA	DE OLIVEIRA
SCHUTT	SCHOTT
YASSLNE	YASSINE
HWOULUNEYULFLLLLL	HOULINNEUF
BERIA	BERIA
HLADEYS	MAELYS
EOZE	EGLE
PSCARLAL	CARLA
WMSRDWBIWOTU	ROUE
WSBAPISTE	BAPTISTE
JEANNE	JEANNE
ASYH	ASYA
PLDAMLEN	DAMIEN
JERCME	JEROME
CWWAHNIWLLEIH	CAMILLE
MSAILNEE	AIMEE
MSPAULINE	PAULINE
SAMUEL	SAMUEL
LEA	LEA
VULLLAUUE	VUILLAUME
VLWFE	JUSTINE
PFCONOT	PICONOT
MLALVIW	ALVIN
MSLWLLVNNYAVKLDVVVLI	DONNARD
DWRHPIERYLLLVLLL	DRAPLER
NARAYANASAUHVANE	NARAYANABAGAVANE
ALYCZA	ALYCIA
WLVLA	OLIVIA
GAETAN	GAETAN
AWMBRE	AMBRE
MSAUBLLINLLLLL	AUBIN
BOWKILFAU	BOURRIEAU
EHY	EMY
DAURIACIUCAYROUIL	DAURIAC-CAYROU
WS	JULES
NALILI	MAI-LI
BAUDET	BAUDET
CWHAPRON	CHAPRON
OICEANE	OLEANE
HOAREAU	HOAREAU
VANLNA	VANINA
LOULS	LOUIS
MSMARLE	MARIE
NUPLOUY	DUPLOUY
ZHANG	ZHANG
WSTRISTAN	TRISTAN
CODDY	CODDY
NRYSTALE	KRYSTALE
LPSELWUE	ELEONORE
DJOE	DJOE
PSLAPVELFVLELLLL	LAVEFVE
ISWHOWNHNEIU	SOFIENE
HLLFALJLLLLII	FAUCOURT
SENUAL	SENECAL
LMSHAGUVL	NAGUI
WNAHJA	NAMIA
WMPMERL	BRINGER
MSELIIHS	ELIAS
CWPAHNOXTVLYMT	GRAMMONT
HWSWLLALLLALVLLL	BELALA
CARLA	CARLA
WRWT	MARGOT
WSFVA	EVA
ROMAFN	ROMAIN
VLALENTINE	VALENTINE
DWCFKNNLIE	FRANCE
IWSHALXTTLIVHELALLUL	MARTINEAU
WKANTERLYLLLVIL	KANTER
EVH	EVA
PSCHAIHAA	CHAIMAA
IWSLYLVDELALLUVVIL	VIDEAU
WWWEAENWW	AREEN
LWUCIE	LUCIE
UYEN	PAYEN
GOUTHIRAUD	GOUTHCRAUD
ANNACLLF	ANNAELLE
PWRHILEA	PAUTHIER
LWAM	LARA
FYONTAINE	FONTAINE
ELLNORE	ELINORE
PLERRF	PIERRE
DFRIBFPOLLES	DE RIBEROLLES
HATHILDEI	MATHIILDE
MSLBCRVDLELALULLL	BORDEAU
AMFOMLM	AMLOMIM
JAULIL	JAULT
CFVAER	CEVAER
ZIISLLHTMOOYDOLWIIM	LANA
PSAILIDDANI	AISSANI
FRVFIER	FRUGIER
IMSMDLRVAFLZZOVLLLL	PEDRAZZOLI
MSVLJCAS	LUCAS
LLWMSRAMAIUURYTOVHBHV	QAVET
LPSCYPRLEN	CYPRIEN
SWMCILHLULLXRVJNJJLL	SCIAUX
FSWUNAY	DAUNAY
NARLUS	MARIUS
MADELEINE	MADELEINE
PSMARGAUX	MARGAUX
AWSESXUDILLLLOLL	ESTUDILLO
MNRLE	MARIE
CROS	CROS
MOHAU	MOREAU
LFFON	LEFORT
LPSTHLFAULT	THIBAULT
JPOVFNEL	JOVINEL
DENLZ	DENIZ
VLRGLLE	VIRGILE
TLMHINULT	THI BAULT
CHERET	CHERET
MAEL	MAEL
RWSGAWLLPLEK	GAUTIER
YGNLS	YANIS
PICLYELROVNTVVY	CLERON
LWPLMOEIVLVASJXEJXVL	DELAGE
WWMWW	DARE DE NAISSANCE CLASSE
LWMIRLMOIULIIJDYHIBRTRLDFL	COLLOMBREN
MANON	NANON
LPSCLILAIIRIEILHU	CLAIRE
NLATHLLS	MATHIS
MMLPVLELHLOUELLLLVLLL	LEMOEL
HMWUMNPWHREYHU	HUMPHREY
WRSTLXAJLLLI	HAD
BEATUCCS	BEATUCCI
WSGWEHILE	GWENOLE
LEFORT	LEFORT
CLPAROLIWE	CAROLINE
AHELIE	AMELIE
MMSYNGULLLLLLYLAULHLELL	GUILLAUME
MMLRBMELLYHVANHDJLLM	BELHADJ
EHHANUFLLE	EMMANUELLE
BLRLZZL	BRIZZI
KAYANL	RAYANE
WPIMLAIVGIAIXRNVVLL	LAGARDE
CAZALLL	CAZALI
MATTHIEU	MATTHIEU
GMWAENLUHIM	GAEL
PMAMA	PAUTET
MSLDEFLOLULLLOLULNLOLUX	DEFOULOUNOUX
BMSEGNFRLLLLLLL	STEINER
NCNGULN	MONGUIN
WLNATHIEU	MATHIEU
ALEXANWE	ALEXANDRE
PMWIEWAWAEIAWAMINE	PIERRE ANTOINE
WSOQTULIQ	ARTHUR
GAARIEL	GABRIEL
MLWAURY	AMAURY
GAUFNETEAU	GAUFRETEAU
WTHVR	ARTHUR
HOFHYE	NOEMIE
CWLPARLRLEUYLIVNLLJR	CARRERE
OLGVEJAA	OLIVEIBA
BERKANE	BERKANE
WOLHAW	NOLHAN
LISA	LISA
ELLSA	ELSA
SWSLLAULLLY	SILLARD
CLEMENT	CLEMENT
LMMIPRMAIVVDTWYNN	RAVEL
HLJACOB	JACOB
MAUAIH	MAURIN
WSHLEXANDRD	ALEXANDRA
LHAFLY	CHARLY
PLML	NOAM
LWOZANOVJJLJVLJ	LOZANO
BWEAUVAL	BEAUVAL
WBRJHOYL	BRIHAY
WMJMLMOINUGTFDAITJUIUL	IONGEAT
JEANNAUD	JEANNAUD
NATHFS	MATHIS
PJBASLLE	BASILE
LMWSRODRLLLOLUESL	RODRIGUES
HWENADLLLLLLLL	MENAD
GATLNEAU	GATINEAU
LEO	LEO
LPSWLAXLLLNL	WAXIN
PJFNZO	ENZO
MLVSFMLLFLLVDIUUDLHJJLVNLLARBUL	MELANAH-BELARDI
GWMABNLWNNM	GABIN
WRIVFJELLL	MORISSOM
HSTHEUIATHIASAN	THEVATHASAN
NLWLALJHAHNHLLL	NATHAN
FUVI	ZOE
MJWULMIWETTECW	JULIETTE
CHYSE	CHLOE
WRTHONE	BERTHONE
NARY	MARY
POWESLE	POUVESLE
JTAMANT	FITAMANT
HALUAJ	HASHAS
WWVOTEAVUUWLVVU	PREVOTEAU
MWEILNEWNMIH	ETIENNE
MWYULS	DUPUIS
UWLDELPOZTE	DELPORTE
IWSLAUTFVVTLYILL	AUZAT
CHARLVE	CHARLOTTE
GLRAW	GIRARD
VWXLCMYWRLCW	VICTOR
RWLVELOH	RIVELON
DWLLCUVELELGLIE	LOVERNE
CLEMFXT	CLEMENT
MMSRMBEIVSSLJEVUINU	BESSE
LMSAMBNE	AMBRE
BRATKIW	BRATKIW
LOPRHA	LORNA
SWLIWMLLL	SLIMANI
PIISPIALLAOIHIAIHLMWIIM	PAIOMA
WMWRNIWNEAW	DORINE
WWMEBWERMNYVJIY	WEBER
WCFRW	DECERGY
MMCPVULUVTLUVALZRELRLU	COUTURIER
UUIJ	LOUIS
MSSOUM	SOLENE
REILAT	REGLAT
JANNF	JANNE
PSSLINON	SIMON
TDSSAUX	TASSAUX
STEFUETZ	STEIMETZ
TRUCLHL	TRUCCHI
WUILLOW	BOUILLON
LYSJEAN	JEAN
MLLAUWBIHJEJ	LABARRE
ITRUWK	TRUNK
CWTIM	CONTINO
MPSMSUIVEUJVRLJITU	SUEUR
LUCLE	LUCILE
LPSHHAWE	ROMANE
LLEN	CLERC
CLILEIIS	OLIVEROS
PSGAEL	GAEL
NMFOUIFM	DEQUIEDT
MWNOENLBIEILW	NOELIE
WLLLELLVLYALUXYYL	LELUUYAUX
WSJNES	INES
PSJAININLAL	JANNA
CHARLEWE	CHARLENE
WIMDNONJ	MANON
PSLOUIAWE	LOU-ANNE
LLINA	LINA
WWLMIWLNSOLIFNFNSGZGA	nan
WWU	PECOU
PLLALURSN	LAUREEN
FYLOFRNN	FLORIAN
IMSBOURLLEYREI	BOURLEYRE
LWSUFWEL	NAWEL
MMSRJMOIUANLTLJJJL	JOAN
ALEXLS	ALEXIS
MMSPMWAIWUHLEJVSULJU	MANHES
PSANLALS	ANAIS
LMMSTNMAIUCLTDJHDZJOLI	MASLAN
BESSAI	BESSAI
MAXENLE	MAXENCE
KLLLLIAN	KILLIAN
WATSE	BLAISE
GWFVHUOLLLLLYIL	GEVAUD
MRSRTMBLOVUUJLLVLLVAVADDX	TROUILLARD
OSCAR	OSCAR
LWSTHEO	THEO
IMYLSTTLLLYLYJLVIFUN	ILLY
MAXLEHXWANDREHM	ALEXANDRE
PSHNOIHE	ANTOINE
OWSDALSSLETLL	BASSET
FWWAMFNWAAM	FATIMA
CECJLE	CECILE
LEROUX	LEROUX
PSNEG	MEG
HAENA	MAENA
MLBASTTDAN	BASTIAAN
XMMAWVLULYSWYVTVLL	KABOUS
HOUNH	MOUNA
KELVYYN	KEVIN
WNWAEMLWLERW	MAELLE
LLWOU	LOU
MMAWWLRLLLLL	MAZZOLA
PLREVAVLT	REVAULT
WSUARLCTTF	CHARLOTTE
CHOJL	CHORIOL
MWORLW	MORIN
WCML	SENEGAL
PSXLEWF	SOLENE
PSMOMAS	THOMAS
NWXRUUKYLILVLLL	MARZOUK
WSYSAUDC	YSAURE
SHWON	SHAVON
FOULOWI	FOULON
WSLSCVHLLVUEPJLJY	SCHLUEP
LANA	LANA
GAURALN	BAURAIN
PSGUILYLAUMLAIV	GUILAUMAIN
PSOCEWE	OCEANE
VELA	VELA
YATLLF	BERTILLE
THLBNUD	THIBAUD
CESAR	CESAR
ANLOLNE	ANTOINE
XYLLAN	KYLLAN
WMCTMGUIVFJCHDIAYRVNIVL	GUICHARD
MMCPOMWIVNOMQUDLUW	RAYNAOD
SJCHOX	SOCHON
THWASSILNE	THOMASSINE
ENLLLE	ENILIE
LWEFEBVRFLLLLLLIL	CEFEBURE
MJREQLYWLNVI	FEREGELY
MDWLE	MAROLE
GIFNVIL	GIRAULT
MMSMOWNILIVLJVNYUQV	ODIC
LWSFSLAM	ESLAM
GULLLAUNE	GUILLAUME
CWWLANRWANW	CLARA
MPSMDUIPVJBTLILYTVL	DUBAIL
ALW	ALBA
KYLLLIAN	KYLLIAN
WMSLILLLLLYLILI	HOEL
WUDNXE	LEONIE
ARTHUR	ARTHUR
PIZOE	ZOE
DAMLA	DAMLA
WLADHUR	ARTHUR
THIBWT	THIBAULT
YWS	BES
MWHYLLLLL	ANCEL
YLELAWALS	LELANOAIS
FWWWF	FONQUERNE
AIBHWNWLFAWIW	CAMELIA
MWRTWNR	BERTRAND
ZOELLE	ZOELIE
FVIVELYFI	CLEMENT
FLOVEVLRLI	QUEVA
IWSBULRAZLELYLIL	BELRAZELI
CLIRLINE	CIRINE
LOUIS	LOUIS
BROSIHACAN	BROS - LACAN
NOREL	MOREL
PSCLOVILLSLIIWLI	CLOVIS
VARVOUX	VARVOUX
VLVJAND	VIVIAND
LADRLZANLU	ADRIAN
PLIISNHJELAONLNSREOUNWIM	HELOISE
LLWSLSLLASYTLRYEYLVVN	SASTRE
LWLLLYIRNF	LILY-ROSE
MSJULIETTE	JULIETTE
PELIUIU	PELLETIER
SOLENNE	SOLENNE
LLMMSRMMLLLTVRRODVVULCULV	MITROVIC
IEWHAINNWIH	ERIN
BMYKAELA	MYKAELA
IRW	IRIS
AEBTIAWUYE	ABBI AWUME
VMERRXVVLLLIIF	VERRI
MSWILLEA	WILLEM
TLXLER	TIXIER
ISWHTAUNIJSLHASLH	STANISLAS
DJOT	PIOT
GAUTHIER	GAUTHIER
DLGABFN	GABIN
RLCHARD	RICHARD
SLWLANLYL	SAMY
ANLURFWL	ANDREW
WSHCHFHFD	MOHAMED
COUDRFY	COUDREY
WSAMFM	ANTOINE
MRSFNBULVILILLELIXVOTTV	GUILLEMOT
ALBAW	ALBAN
JULE	JULES
MMSMHWLIJURHJDFULJHYJ	MICHEL
LERJY	LEROY
CPINJO	CAINJO
LWSLAULOYHVLVVI	LAWSON
ANICE	AMICE
MWLMMCDILUVBYLLZYUSZ	SALVI
PSANILCLNE	ANTOINE
UWVRAWVVULLVVI	LIVRAN
INANE	IMANE
AXEL	AXEL
DWURLIJN	DORIAN
NOEHZE	NOEMIE
LWCEYNWA	EYNOLA
GODB	GODI
LPSGCEIILN	QUENTIN
CMWLEMMWNTFNENW	CLEMENTINE
WSNAX	NAX
HWFPHFTLLLLL	HERHET
AALFHFHNT	MALENFANT
AMRI	AMRI
MSLBHRRIELLLLLI	BARRE
DEBARRAUL	DE BARRAU
PSNANON	MANON
HLSMARLILALNLL	MARIAN
PSXUCALS	LUCAS
WMSPMGAIAVNTGIBVQNYU	GRANGE
NEERSCHHAN	MEERSCHMAN
MSLLLYAOLIVLLLL	LIAO
PIISOPANULLIONNLHMIIW	PAUL
HECTOR	HECTOR
BWMOUMRELMELUDLUVLL	BOURREL
WHAUXLVLLIJYLL	RENAUX
EIEANOEE	ELEANORE
WAWLBMAWNEW	ALBANE
HAMIN	MARTIN
WLILLRTT	LAMBERT
MIWLHHAWHNW	ILHAM
MBTHINBWHUDHW	THIBAUD
AMANDINE	AMANDINE
MMLTCVHLAVWGVVEGYUVI	CHAUVEAU
PSAHARAWDEI	AMARANDE
MSLAGOSLTILNLOLL	AGOSTINO
IWTSLRLFLVDUERUUTUUUJ	RADERT
PLALFXANURA	ALEXANDRA
WMWYNAWWINWI	PAYAN
MWAYUILC	MATHIS
CHEUFLLLCK	CHEVALIER
PLEVA	EVA
EMMA	EMMA
LECLERCQ	LECLERCQ
PSAJBILV	AUBIN
TLDUALNE	TIPHAINE
MARREO	MATTEO
BWINETLLLLL	BINET
WWL	BEDEL
GYOUBEAUX	GOUBEAUX
TASRAYRL	TASTAYRE
ALMLEXANJRE	ALEXANDRE
WLZNYMMANUELA	WINNY MANUELA
PEYRUQUEOU	PEYRUQUEO
PLALEXIA	ALEXIA
TFLLUT	TEILLET
WUYJSINLLLLL	LAVERSIN
WIAHNA	ANNA
WVIN	KEVIN
SLADL	SIADI
PIIISSLHOZMHOHNNNLNWID	SARAH
HLSIMOHL	SIMON
YAFRTIN	MARTIN
FJANDROIISIAFWUALW	FLANDROIS-ARDOUAIN
JIUSTLINE	JUSTINE
LEHLKHAYEA	LEMKHAYER
VOAN	YOAN
MLWLARJLEFLLLLL	MARIA
WSFLOFAN	FLORIAN
THOHAS	THOMAS
THORNG	THORNG
LFSALNT	LE SAINT
LWARPADEI	LARRADE
SLLEJLTLILLL	QUEATIN
PSALI	ALI
PLIIUAS	ILYAS
MMWIWNWEAW	AMINE
AHNA	ANNA
HLOCCHI	MOCCHI
GMLLRLELFLLYLLAAURII	GREE
NERGLZ	NERGIZ
NSWANNNVWELHW	SAMUEL
WSRLOLULILYILLENEUVE	RIOU VILLENEUVE
LWSLOUNES	LOUNES
PIHIAXILOHIEIL	MAXIME
PLANANDLNE	AMANDINE
MWRAJNAWAIIW	RAJAA
CHANBEYROW	CHAMBEYRON
MWGLAWDWYSHW	GLADYS
AWBUBNDWIM	AUGO
WSCORENTIN	CORENTIN
PLLANVDRLILNL	LANDRIN
LAVERGNFIIPOUGFT	LAVERGNE--POUGET
MBNWHW	C
VHENTFNE	VALENTINE
ANTOLINE	ANTOINE
NURY	NURY
HBILLVA	NAEVA
GERBEAUIVERLEURE	GERBEAU-VERLEURE
LALAWTHIEU	MATHIEU
FHULK	EMMLE
PSARJTHIUX	ARTHUR
ULIISPSAL	VISSAL
MARCATO	MARCATO
WFNZO	ENZO
GBWCLFL	GABRIEL
UNG	UNG
ABIGAIL	ABIGAIL
UEUTTER	REUTTER
WWLUTWNSDVNNUJDHORRSSF	JOVANDET
BHWAT	BARNAT
IWSULVUNWWYY	LE ROYER
FALL	FALL
GIRAUPR	GIRAUPH
WUAO	OZUAG
ANBRE	AMBRE
IWSLCHELLVRLILELRLLV	CHEVRIER
TMWHHHWHM	THEO
VWISSACLILLDVIL	VISSAC
MMWATHHWLSNM	MATHIS
XLLL	KILL
MYIMER	POIRIER
MSSACHA	SACHA
LUMASSANDRA	KASSANDRA
FARRET	FARRET
HYAMAL	HAMAT
THWAS	THOMAS
REHOXD	REMOND
PSFANNY	FANNY
HWARLLWF	MARINE
DALLIES	DALLIES
SUW	LOUIS
WJWSSEH	WISSEN
WRW	MARGOT
LAMACHE	LAMANCHE
LHAMBAZ	CHAMBAZ
RIBALLLLIEA	RIBAILLIER
WFWLAWMWEZLNW	FLAMEZL
ELPLLEMXAY	ELLEN-RAY
WPIL	BRIL
NAIS	NAIS
LPIIOIULJIWIN	nan
LMMJPCMLIOVPUIYNVVUUN	CLOPIN
LMWDMYWSLR	DAUSAR
PSDAEL	NAEL
OJQNO	DJINO
ALLCK	ALICE
HLFW	OSCAR
NALLXA	MALIKA
PEVTALS	BENTALEB
PIHLANOW	MANON
SACHA	SACHA
WSMARGAUX	MARGAUX
LWITHOMAS	THOMAS
MORENOBENULLIU	MORENOBEAULIEU
ZLDI	ZIDI
GMAHA	GACHON
WSDYLAN	DYLAN
BERENFCE	BERENICE
CHARLES	CHARLES
SCHWARZ	SCHWARZ
LWELOUTRELILLVLLL	LELOUTRE
OUMOYW	OUMAYMA
PLMANOH	MANON
WWJIW	PAUITNE
MREGNQER	REGNIER
WSJOHAI	JOMAI
CWBLAMRWAOW	CLARA
PSWHWIINMWNO	BARDIN MARINO
HWEOJAHRIL	MEDJAHRI
WUWCMAWSNW	LUCAS
CHFRLWTF	CHARLOTTE
MLDASILVA	DA SILVA
PSOCEANE	OCEANE
LLMOU	LOU
CEKBAUIT	GERBAULT
IWSGOUZONNAT	GOUZONNAT
LLPJPLIEKLKE	PIERRE
PSTREPOLSL	TREPOS
VLCTOK	VICTOR
LLUCLIE	LUCIE
AYHFPIL	AYHERIC
PLWAULINE	PAULINE
MSILOIIFWII	LOPEZ
CAHILLE	CAMILLE
ALCA	ALCA
APOLLGLNE	APOLLINE
WWLAYLLLLLLIL	DOLAY
LWSHUGO	HUGO
XUCAS	LUCAS
FLUHR	FLUHR
ALWTYMNYN	ANTHONYN
STELLA	STELLA
WPFRA	PIRA
LPLLLLFLCHALRLBVINTLLYL	CHARBIT
AXILL	AXEL
WSVANESSA	VANESSA
WRSYRLLALVULLTVIJJVV	RAULT
FANNY	FANNY
JMBUUNSWNW	SULES
TWWRLMSWTANW	TRISTAN
WSEVA	EVA
WFNC	WANG
QUREMTN	QUENTIN
BFMI	REMI
MYSFLFAVSEITJDJVLV	LAGET
CARLA	CARLA
CMUSL	COTS
IEMCLLCLLCY	LEMELLETIER
BEZIAT	BEZIAT
LLPSLLLIHLLOSTJLLS	LHOSTIS
BELORGEDT	BELORGUET
EMLBATMI	ELBATMI
MHTTUILAS	MATTTHIAS
ALSYAEILA	ROSAPIE
VAVTRZV	VAUTRIN
KIMBERLEY	KIMBERLY
AUDFBME	AUDIGANE
PSTHIBAUILT	THIBAULT
PSYASMLNA	YASMINA
HMSLBRWLLSVYJLVITLELLLLECHELA	BROSSET-TELLECHEA
PSMFRGAUX	MARGAUX
WNILILA	KAMILIA
MENARD	MENARD
WRGANE	MORGANE
WMSMMLRLHLLJLUTITYIXI	CCHULTZ
NPAVRYFLFARISSL	MAURY EL PARISSI
CLMLARYJE	CLARYSSE
LLWRAN	LIAM
YOHANN	YOHANN
ELLIOTT	ELIOTT
ANNONY	ANTHONY
LLWMCRIVMAIZULYLHUBDMUW	VAILLANT
DAOTEL	BROTEL
IWSFSILLSSEJALJ	POUSSEAU
MMZMHMOIUFJLAJCLKOOJV	HOFLACK
WMSMMHQIAVOCHJFLYLW	MAACHE